"","X","remakes_title","remakes_year","originals_title","originals_year","yearsBetween"
"1",1,"12 Angry Men (1997) dir. William Friedkin","1997","Twelve Angry Men (1954) dir. Franklin Schaffner",1954,43
"2",2,"12 Angry Men (1957) dir. Sidney Lumet","1957","Twelve Angry Men (1954) dir. Franklin Schaffner",1954,3
"3",3,"13 (2010) dir. G̩la Babluani","2010","13 Tzameti (2005) dir. G̩la Babluani",2005,5
"4",4,"13 Assassins (2011) dir. Takashi Miike","2011","J��san-nin no shikaku (1963) dir. Eiichi Kudo",1963,48
"5",5,"The 13th Letter (1951) dir. Otto Preminger","1951","Le Corbeau (1943) dir. Henri-Georges Clouzot",1943,8
"6",6,"101 Dalmatians (1996) dir. Stephen Herek","1996","One Hundred and One Dalmatians (1961) dir. Clyde Geronimi
Based on the novel by Dodie Smith",1961,35
"7",7,"2001 Maniacs (2005) dir. Tim Sullivan","2005","Two Thousand Maniacs! (1964) dir. Herschell Gordon Lewis",1964,41
"8",8,"Three Godfathers (1936) dir. Richard Boleslawski","1936","Hell's Heroes (1930) dir. William Wyler",1930,6
"9",9,"3 Godfathers (1948) dir. John Ford","1948","Hell's Heroes (1930) dir. William Wyler",1930,18
"10",10,"3 Idiotas (2017) dir. Carlos Bolado","2017","3 Idiots (2009) dir. Rajkumar Hirani",2009,8
"11",11,"3:10 to Yuma (2007) dir. James Mangold","2007","3:10 to Yuma (1957) dir. Delmer Daves",1957,50
"12",12,"Nineteen Eighty-Four (1984) dir. Michael Radford","1984","1984 (1956) dir. Michael AndersonNineteen Eighty-Four (1954) dir. Rudolph Cartier1984 (1953) dir. Paul Nickell",1956,28
"13",13,"A Southern Yankee (1948) dir. Edward Sedgwick","1948","The General (1926) dir. Buster Keaton & Clyde Bruckman",1926,22
"14",14,"Adventures of Don Juan (1948) dir. Vincent Sherman","1948","Don Juan (1926) dir. Alan Crosland",1926,22
"15",15,"An Affair to Remember (1957) dir. Leo McCarey","1957","Love Affair (1939) dir. Leo McCarey",1939,18
"16",16,"Against All Odds (1984) dir. Taylor Hackford","1984","Out of the Past (1947) dir. Jacques Tourneur",1947,37
"17",17,"Alfie (2004) dir. Charles Shyer","2004","Alfie (1966) dir. Lewis Gilbert",1966,38
"18",18,"Algiers (1938) dir. John Cromwell","1938","P̩p̩ le Moko (1937) dir. Julien Duvivier",1937,1
"19",19,"All Quiet on the Western Front (1979) dir. Delbert Mann","1979","All Quiet on the Western Front (1930) dir. Lewis Milestone",1930,49
"20",20,"Always (1989) dir. Steven Spielberg","1989","A Guy Named Joe (1943) dir. Victor Fleming",1943,46
"21",21,"The Amityville Horror (2005) dir. Andrew Douglas","2005","The Amityville Horror (1979) dir. Stuart Rosenberg
Based on the novel by Jay Anson",1979,26
"22",22,"And God Created Woman (1988) dir. Roger Vadim","1988","Et Dieu... cr̩a la femme (1956) dir. Roger Vadim",1956,32
"23",23,"And Soon the Darkness (2010) dir. Marcos Efron","2010","And Soon the Darkness (1970) dir. Robert Fuest",1970,40
"24",24,"Angels in the Outfield (1994) dir. William Dear","1994","Angels in the Outfield (1951) dir. Clarence Brown",1951,43
"25",25,"Angel on My Shoulder (1980) dir. John Berry","1980","Angel on My Shoulder (1946) dir. Archie Mayo",1946,34
"26",26,"Annie (2014) dir. Will GluckAnnie (1999) dir. Rob Marshall","2014","Annie (1982) dir. John Huston
Both based on the Thomas Meehan/Charles Strouse/Martin Charnin musical, which in turn came from the comic strip Little Orphan Annie, by Harold Gray",1982,32
"27",27,"Annavaram (2006) dir. Bhimaneni Srinivas Rao","2006","Thirupaachi (2005) dir. Perarasu",2005,1
"28",28,"Another Fine Mess (1930) dir. James Parrott","1930","Duck Soup (1927) dir. Fred Guiol",1927,3
"29",29,"Another Part of the Forest (1972) dir. Daniel Mann","1972","Another Part of the Forest (1948) dir. Michael Gordon",1948,24
"30",30,"Anthropophagous 2000 (1999) dir. Andreas Schnaas","1999","Antropophagus (1980) dir. Joe D'Amato",1980,19
"31",31,"Applause (1973) dir. Ron Field & Bill Foster","1973","All About Eve (1950) dir. Joseph L. Mankiewicz",1950,23
"32",32,"April Fool's Day (2008) dir. Mitchell Altieri & Phil Flores","2008","April Fool's Day (1986) dir. Fred Walton",1986,22
"33",33,"Bhool Bhulaiyaa (2008) dir. Priyadarshan","2008","Manichitrathazhu (1993) dir. Fazil",1993,15
"34",34,"Rajmohol (2005) dir. Swapan Saha","2005","Manichitrathazhu (1993) dir. Fazil",1993,12
"35",35,"Chandramukhi (2005) dir. P. Vasu","2005","Manichitrathazhu (1993) dir. Fazil",1993,12
"36",36,"Apthamitra (2004) dir. P. Vasu","2004","Manichitrathazhu (1993) dir. Fazil",1993,11
"37",37,"Around the World in 80 Days (1956) dir. Michael Anderson","1956","Around the World in Eighty Days (1919) dir. Richard Oswald",1919,37
"38",38,"Around the World in 80 Days (2004) dir. Frank Coraci","2004","Around the World in Eighty Days (1919) dir. Richard Oswald",1919,85
"39",39,"The Arena (2001) dir. Timur Bekmambetov","2001","The Arena (1974) dir. Steve Carver",1974,27
"40",40,"Arthur (2011) dir. Jason Winer","2011","Arthur (1981) dir. Steve Gordon",1981,30
"41",41,"Assault on Precinct 13 (2005) dir. Jean-Fran̤ois Richet","2005","Assault on Precinct 13 (1976) dir. John Carpenter",1976,29
"42",42,"Attack of the 50 Ft. Woman (1993) dir. Christopher Guest","1993","Attack of the 50 Foot Woman (1958) dir. Nathan H. Juran",1958,35
"43",43,"The Bachelor (1999) dir. Gary Sinyor","1999","Seven Chances (1925) dir. Buster Keaton",1925,74
"44",44,"Bachelor Mother (1939) dir. Garson Kanin","1939","Little Mother (1935) dir. Henry Koster",1935,4
"45",45,"Back Street (1941) dir. Robert Stevenson","1941","Back Street (1932) dir. John M. Stahl",1932,9
"46",46,"Back Street (1961) dir. David Miller","1961","Back Street (1932) dir. John M. Stahl",1932,29
"47",47,"Bad News Bears (2005) dir. Richard Linklater","2005","The Bad News Bears (1976) dir. Michael Ritchie",1976,29
"48",48,"The Ballad of Narayama (1983) dir. Shohei Imamura","1983","The Ballad of Narayama (1958) dir. Keisuke Kinoshita",1958,25
"49",49,"The Bad Seed (1985) dir. Paul Wendkos","1985","The Bad Seed (1956) dir. Mervyn LeRoy",1956,29
"50",50,"Bangkok Dangerous (2008) dir. The Pang Brothers","2008","Bangkok Dangerous (1999) dir. The Pang Brothers",1999,9
"51",51,"A Night in Casablanca (1946) dir. Archie Mayo","1946","Casablanca (1942) dir. Michael Curtiz",1942,4
"52",52,"Barb Wire (1996) dir. David Hogan","1996","Casablanca (1942) dir. Michael Curtiz",1942,54
"53",53,"The Magnificent Seven (1960) John Sturges","1960","Shichinin no samurai (1954) dir. Akira Kurosawa",1954,6
"54",54,"Battle Beyond the Stars (1980) dir. Jimmy T. Murakami","1980","Shichinin no samurai (1954) dir. Akira Kurosawa",1954,26
"55",55,"The Magnificent Seven (2016) dir. Antoine Fuqua","2016","Shichinin no samurai (1954) dir. Akira Kurosawa",1954,62
"56",56,"The Battle of the Sexes (1928) dir. D. W. Griffith","1928","The Battle of the Sexes (1914) dir. D. W. Griffith",1914,14
"57",57,"The Beat that My Heart Skipped (2005) dir. Jacques Audiard","2005","Fingers (1978) dir. James Toback",1978,27
"58",58,"The Last Remake Of Beau Geste (1977) dir. Marty Feldman","1977","Beau Geste (1926) dir. Herbert Brenon
Based on the book by P. C. Wren",1926,51
"59",59,"Beau Geste (1966) dir. Douglas Heyes","1966","Beau Geste (1926) dir. Herbert Brenon
Based on the book by P. C. Wren",1926,40
"60",60,"Beau Geste (1939) dir. William A. Wellman","1939","Beau Geste (1926) dir. Herbert Brenon
Based on the book by P. C. Wren",1926,13
"61",61,"Beauty and the Beast (2017) dir. Bill Condon","2017","Beauty and the Beast (1991) dir. Gary Trousdale & Kirk Wise",1991,26
"62",62,"Bedazzled (2000) dir. Harold Ramis","2000","Bedazzled (1967) dir. Stanley Donen",1967,33
"63",63,"The Beguiled (2017) dir. Sofia Coppola","2017","The Beguiled (1971) dir. Don Siegel
Based on the novel A Painted Devil by Thomas P. Cullinan",1971,46
"64",64,"Being Julia (2004) dir. Istv��n Szab�_","2004","Adorable Julia (1964) dir. Alfred Weidenmann",1964,40
"65",65,"Ben-Hur (1959) dir. William Wyler","1959","Ben-Hur (1925) dir. Fred Niblo",1925,34
"66",66,"Ben-Hur (2016) dir. Timur Bekmambetov","2016","Ben-Hur (1925) dir. Fred Niblo",1925,91
"67",67,"Beongeoli Sam-ryong (1964) dir. Shin Sang-ok","1964","Beongeoli Sam-ryong (1929) dir. Na Woon-gyu",1929,35
"68",68,"Between Two Worlds (1944) dir. Edward A. Blatt","1944","Outward Bound (1930) dir. Robert Milton",1930,14
"69",69,"Frutto acerbo (1934) dir. Carlo Ludovico Bragaglia","1934","A Precocious Girl (1934) dir. Max Neufeld and Richard Eichberg",1934,0
"70",70,"Between Us Girls (1942) dir. Henry Koster","1942","A Precocious Girl (1934) dir. Max Neufeld and Richard Eichberg",1934,8
"71",71,"Beyond a Reasonable Doubt (2009) dir. Peter Hyams","2009","Beyond a Reasonable Doubt (1956) dir. Fritz Lang",1956,53
"72",72,"Broken Lance (1954) dir. Edward Dmytryk","1954","House of Strangers (1949) dir. Joseph L. Mankiewicz",1949,5
"73",73,"The Big Show (1961) dir. James B. Clark","1961","House of Strangers (1949) dir. Joseph L. Mankiewicz",1949,12
"74",74,"The Big Stampede (1932) dir. Tenny Wright","1932","Land Beyond the Law (1927) dir. Harry Joe Brown",1927,5
"75",75,"Mr. Smith Goes to Washington (1939) dir. Frank Capra","1939","Washington Merry-Go-Round (1932) dir. James Cruze",1932,7
"76",76,"Billy Jack Goes to Washington (1977) dir. Tom Laughlin","1977","Washington Merry-Go-Round (1932) dir. James Cruze",1932,45
"77",77,"The Birdcage (1996) dir. Mike Nichols","1996","La Cage aux Folles (1978) dir. ��douard Molinaro",1978,18
"78",78,"Black Caesar (1973) dir. Larry Cohen","1973","Little Caesar (1931) dir. Mervyn LeRoy",1931,42
"79",79,"Black Christmas (2006) dir. Glen Morgan","2006","Black Christmas (1974) dir. Bob Clark",1974,32
"80",80,"Blame it on Rio (1984) dir. Stanley Donen","1984","Un moment d'egarement (1977) dir. Claude Berri",1977,7
"81",81,"The Blob (1988) dir. Chuck Russell","1988","The Blob (1958) dir. Irvin S. Yeaworth Jr.",1958,30
"82",82,"Blood Diner (1987) dir. Jackie Kong","1987","Blood Feast (1963) dir. Herschell Gordon Lewis",1963,24
"83",83,"The Blue Angel (1959) dir. Edward Dmytryk","1959","The Blue Angel (1930) dir. Josef von Sternberg",1930,29
"84",84,"The Blue Bird (1940) dir. Walter Lang","1940","The Blue Bird (1918) dir. Maurice Tourneur",1918,22
"85",85,"The Blue Bird (1976) dir. George Cukor","1976","The Blue Bird (1918) dir. Maurice Tourneur",1918,58
"86",86,"Bored of Education (1936) dir. Gordon Douglas","1936","Teacher's Pet (1930) dir. Robert F. McGowan",1930,6
"87",87,"Born Yesterday (1993) dir. Luis Mandoki","1993","Born Yesterday (1950) dir. George Cukor
Based on the play by Garson Kanin",1950,43
"88",88,"Boudu (2005) dir. G̩rard Jugnot","2005","Boudu Saved from Drowning (1932) dir. Jean Renoir",1932,73
"89",89,"The Boy Cried Murder (1966) dir. George P. Breakston","1966","The Window (1949) dir. Ted Tetzlaff
Based on The Boy Cried Murder by Cornell Woolrich",1949,17
"90",90,"Breathless (1983) dir. Jim McBride","1983","Breathless (1960) dir. Jean-Luc Godard",1960,23
"91",91,"Three on a Spree (1961) Sidney J. Furie","1961","Brewster's Millions (1945) dir. Allan Dwan",1945,16
"92",92,"Brewster's Millions (1985) dir. Walter Hill","1985","Brewster's Millions (1945) dir. Allan Dwan",1945,40
"93",93,"Bride Wars (2015) dir. Tony Chan","2015","Bride Wars (2009) dir. Gary Winick",2009,6
"94",94,"Brian's Song (2001) dir. John Gray","2001","Brian's Song (1971) dir. Buzz Kulik",1971,30
"95",95,"Brothers (2009) dir. Jim Sheridan","2009","Br��dre (2004) dir. Susanne Bier",2004,5
"96",96,"A Bucket of Blood (1995) dir. Michael McDonald","1995","A Bucket of Blood (1959) dir. Roger Corman",1959,36
"97",97,"Buddy Buddy (1981) dir. Billy Wilder","1981","L'Emmerdeur (1973) dir. Edouard Molinaro",1973,8
"98",98,"The Buccaneer (1958) dir. Anthony Quinn","1958","The Buccaneer (1938) dir. Cecil B. DeMille",1938,20
"99",99,"Bundle of Joy (1956) dir. Norman Taurog","1956","Bachelor Mother (1939) dir. Garson Kanin",1939,17
"100",100,"The Burmese Harp (1985) dir. Kon Ichikawa","1985","The Burmese Harp (1956) dir. Kon Ichikawa",1956,29
"101",101,"Cabin Fever (2016) dir. Travis Zariwny","2016","Cabin Fever (2002) dir. Eli Roth",2002,14
"102",102,"The Cabinet of Dr. Caligari (2005) dir. David Lee Fisher","2005","The Cabinet of Dr. Caligari (1920) dir. Robert Wiene",1920,85
"103",103,"Cape Fear (1991) dir. Martin Scorsese","1991","Cape Fear (1962) dir. J. Lee Thompson
Based on the novel The Executioners by John D. MacDonald",1962,29
"104",104,"The Captain (1971) dir. Kurt Hoffmann","1971","The Captain's Table (1959) dir. Jack Lee
Based on a novel by Richard Gordon",1959,12
"105",105,"Carnival of Souls (1998) dir. Adam Grossman & Ian Kessner","1998","Carnival of Souls (1962) dir. Herk Harvey",1962,36
"106",106,"Carrie (2002) dir. David Carson","2002","Carrie (1976) dir. Brian De Palma
Based on the novel by Stephen King",1976,26
"107",107,"Carrie (2013) dir. Kimberly Peirce","2013","Carrie (1976) dir. Brian De Palma
Based on the novel by Stephen King",1976,37
"108",108,"The Cat Creeps (1930) dir. Rupert Julian","1930","The Cat and the Canary (1927) dir. Paul Leni",1927,3
"109",109,"The Cat and the Canary (1939) dir. Elliott Nugent","1939","The Cat and the Canary (1927) dir. Paul Leni",1927,12
"110",110,"Cat People (1982) dir. Paul Schrader","1982","Cat People (1942) dir. Jacques Tourneur",1942,40
"111",111,"Catch That Kid (2004) dir. Bart Freundlich","2004","Klatret��sen (2002) dir. Hans Fabian",2002,2
"112",112,"Carousel (1956) dir. Henry KingLiliom (1934) dir. Fritz Lang","1956","Liliom (1930) dir Frank Borzage",1930,26
"113",113,"The Champ (1979) dir. Franco Zeffirelli","1979","The Champ (1931) dir. King Vidor",1931,48
"114",114,"Cheaper by the Dozen (2003)","2003","Cheaper by the Dozen (1950)",1950,53
"115",115,"Chickens Come Home (1931) dir. Hal Roach","1931","Love 'em and Weep (1927) dir. Fred Guiol",1927,4
"116",116,"The Children's Hour (1961) dir. William Wyler","1961","These Three (1936) dir. William Wyler
Based on the 1934 play The Children's Hour, by Lillian Hellman",1936,25
"117",117,"A Christmas Carol (1999) dir. David Jones","1999","Scrooge (1935) dir. Henry Edwards",1935,64
"118",118,"A Christmas Carol (1984) dir. Clive Donner","1984","Scrooge (1935) dir. Henry Edwards",1935,49
"119",119,"Scrooge (1951) dir. Brian Desmond Hurst","1951","Scrooge (1935) dir. Henry Edwards",1935,16
"120",120,"A Christmas Carol (1938) dir. Edwin L. Marin","1938","Scrooge (1935) dir. Henry Edwards",1935,3
"121",121,"A Christmas Carol (2009) dir. Robert Zemeckis","2009","Scrooge (1935) dir. Henry Edwards",1935,74
"122",122,"Chloe (2009) dir. Atom Egoyan","2009","Nathalie... (2004) dir. Anne Fontaine",2004,5
"123",123,"Cinderella (2015)","2015","Cinderella (1950)",1950,65
"124",124,"City of Angels (1998) dir. Brad Silberling","1998","Der Himmel �_ber Berlin or Wings of Desire (1987) dir. Wim Wenders",1987,11
"125",125,"Clash of the Titans (2010) dir. Louis Leterrier","2010","Clash of the Titans (1981) dir. Desmond Davis",1981,29
"126",126,"Classmates (2007) dir. K. Vijaya Bhaskar","2007","Classmates (2006) dir. Lal Jose",2006,1
"127",127,"The Boy Cried Murder (1966) dir. George P. Breakston","1966","The Window (1949) dir. Ted Tetzlaff
Based on The Boy Cried Murder by Cornell Woolrich",1949,17
"128",128,"Cloak & Dagger (1984) dir. Richard Franklin","1984","The Window (1949) dir. Ted Tetzlaff
Based on The Boy Cried Murder by Cornell Woolrich",1949,35
"129",129,"Colorado Territory (1949) dir. Raoul Walsh","1949","High Sierra (1941) dir. Raoul Walsh",1941,8
"130",130,"The Computer Wore Tennis Shoes (1995) dir. Peyton Reed","1995","The Computer Wore Tennis Shoes (1969) dir. Robert Butler",1969,26
"131",131,"Confession (1937) dir. Joe May","1937","Mazurka (1935) dir. Willi Forst",1935,2
"132",132,"The Counter Jumper (1922) dir. Larry Semon","1922","The Grocery Clerk (1919) dir. Larry Semon",1919,3
"133",133,"Cousins (1989) dir. Joel Schumacher","1989","Cousin, cousine (1975) dir. Jean-Charles Tacchella",1975,14
"134",134,"Crackers (1984) dir. Louis Malle","1984","Big Deal on Madonna Street (1958) dir. Mario Monicelli",1958,26
"135",135,"The Crazies (2010) dir. Breck Eisner","2010","The Crazies (1973) dir. George A. Romero",1973,37
"136",136,"Crime School (1938) dir. Lewis Seiler","1938","The Mayor of Hell (1933) dir. Archie Mayo & Michael Curtiz",1933,5
"137",137,"Criminal (2004) dir. Gregory Jacobs","2004","Nueve reinas (2000) dir. Fabi��n Bielinsky",2000,4
"138",138,"D.O.A. (1988) dir. Annabel Jankel & Rocky Morton","1988","D.O.A. (1950) dir. Rudolph Mat̩",1950,38
"139",139,"Dante's Inferno (1935) dir. Harry Lachman","1935","Dante's Inferno (1924) dir. Henry Otto",1924,11
"140",140,"The Dark Mirror (1984) dir. Richard Lang","1984","The Dark Mirror (1946) dir. Robert Siodmak",1946,38
"141",141,"Stolen Hours (1963) dir. Daniel Petrie","1963","Dark Victory (1939) dir. Edmund Goulding
Based on the play by George Emerson Brewer Jr. and Bertram Bloch",1939,24
"142",142,"Dark Victory (1976) dir. Robert Butler","1976","Dark Victory (1939) dir. Edmund Goulding
Based on the play by George Emerson Brewer Jr. and Bertram Bloch",1939,37
"143",143,"Dark Water (2005) dir. Walter Salles","2005","Dark Water (2002) dir. Hideo Nakata",2002,3
"144",144,"Dawn of the Dead (2004) dir. Zack Snyder","2004","Dawn of the Dead (1978) dir. George A. Romero",1978,26
"145",145,"The Dawn Patrol (1938) dir. Edmund Goulding","1938","The Dawn Patrol (1930) dir. Howard Hawks",1930,8
"146",146,"Day of the Dead (2008) dir. Steve Miner","2008","Day of the Dead (1985) dir. George A. Romero",1985,23
"147",147,"The Day the Earth Stood Still (2008) dir. Scott Derrickson","2008","The Day the Earth Stood Still (1951) dir. Robert Wise",1951,57
"148",148,"Dead of Winter (1987) dir. Arthur Penn","1987","My Name Is Julia Ross (1945) dir. Joseph H. Lewis",1945,42
"149",149,"Death at a Funeral (2010) dir. Neil LaBute","2010","Death at a Funeral (2007) dir. Frank Oz",2007,3
"150",150,"Death Race (2008) dir. Paul W.S. Anderson","2008","Death Race 2000 (1975) dir. Paul Bartel",1975,33
"151",151,"Death Wish (2017) dir. Eli Roth","2017","Death Wish (1974) dir. Michael Winner",1974,43
"152",152,"The Debt (2011) dir. John Madden","2011","The Debt (2007) dir. Assaf Bernstein",2007,4
"153",153,"The Defiant Ones (1986) dir. David Lowell Rich","1986","The Defiant Ones (1958) dir. Stanley Kramer",1958,28
"154",154,"The Departed (2006) dir. Martin Scorsese","2006","Infernal Affairs (2002) dir. Wai Keung Lau & Siu Fai Mak",2002,4
"155",155,"Desire (1936) dir. Frank Borzage","1936","Happy Days in Aranjuez (1933) dir. Johannes Meyer",1933,3
"156",156,"Desperate Hours (1990) dir. Michael Cimino","1990","The Desperate Hours (1955) dir. William Wyler
Based on the novel and play by Joseph Hayes",1955,35
"157",157,"Destry Rides Again (1939) dir. George Marshall","1939","Destry Rides Again (1932) dir. Benjamin Stoloff",1932,7
"158",158,"Destry (1954) dir. George Marshall","1954","Destry Rides Again (1932) dir. Benjamin Stoloff",1932,22
"159",159,"Le Deuxi̬me Souffle (2007) dir. Alain Corneau","2007","Le Deuxi̬me Souffle (1966) dir. Jean-Pierre Melville",1966,41
"160",160,"Diabolique (1996) dir. Jeremiah S. Chechik","1996","Les Diaboliques (1955) dir. Henri-Georges Clouzot
From the novel by Pierre Boileau and Thomas Narcejac",1955,41
"161",161,"Diamond Horseshoe (1945) dir. George Seaton","1945","The Barker (1928) dir. George Fitzmaurice",1928,17
"162",162,"Die Rothschilds (1940) dir. Erich Waschneck","1940","The House of Rothschild (1934) dir. Alfred L. Werker",1934,6
"163",163,"Dirty Rotten Scoundrels (1988) dir. Frank Oz","1988","Bedtime Story (1964) dir. Ralph Levy",1964,24
"164",164,"Dr. Jekyll and Mr. Hyde (1941) dir. Victor Fleming","1941","Dr. Jekyll and Mr. Hyde (1931) dir. Rouben Mamoulian",1931,10
"165",165,"Dr. M (1990) dir. Claude Chabrol","1990","Dr. Mabuse the Gambler (1922) dir. Fritz Lang",1922,68
"166",166,"Yugandhar (1979) dir. K. S. R. Das","1979","Don (1978) dir. Chandra Barot",1978,1
"167",167,"Billa (1980) dir. R. Krishnamurthy","1980","Don (1978) dir. Chandra Barot",1978,2
"168",168,"Sobharaj (1986) dir. Sasikumar","1986","Don (1978) dir. Chandra Barot",1978,8
"169",169,"Billa (2007) dir. VishnuvardhanDon (2006) dir. Farhan Akhtar","2007","Don (1978) dir. Chandra Barot",1978,29
"170",170,"Billa (2009) dir. Meher Ramesh","2009","Don (1978) dir. Chandra Barot",1978,31
"171",171,"A Dog of Flanders (1999) dir. Kevin Brodie","1999","A Dog of Flanders (1959) dir. James B. Clark",1959,40
"172",172,"Dorian Gray (2009) dir. Oliver Parker","2009","The Picture of Dorian Gray (1945) dir. Albert Lewin",1945,64
"173",173,"Down (2001) dir. Dick Maas","2001","De Lift (1983) dir. Dick Maas",1983,18
"174",174,"Down and Out in Beverly Hills (1986) dir. Paul Mazursky","1986","Boudu sauv̩ des eaux (1932) dir. Jean Renoir",1932,54
"175",175,"Heaven Can Wait (1978) dir. Warren Beatty & Buck Henry","1978","Here Comes Mr. Jordan (1941) dir. Alexander Hall",1941,37
"176",176,"Down to Earth (2001) dir. Chris Weitz & Paul Weitz","2001","Here Comes Mr. Jordan (1941) dir. Alexander Hall",1941,60
"177",177,"Dreaming Lips (1937) dir. Paul Czinner","1937","Dreaming Lips (1932) dir. Paul Czinner",1932,5
"178",178,"Dumbo (2019) dir. Tim Burton","2019","Dumbo (1941) dir. Ben Sharpsteen",1941,78
"179",179,"The Echo (2008) dir. Yam Laranas","2008","Sigaw (2004) dir. Yam Laranas",2004,4
"180",180,"EDtv (1999) dir. Ron Howard","1999","Louis 19, King of the Airwaves (Louis 19, le roi des ondes) (1994) dir. Michel Poulette",1994,5
"181",181,"Sri Mahalakshmi (2007) dir. Vijayan","2007","Groundhog Day (1993) dir. Harold Ramis",1993,14
"182",182,"�� gi�� ieri (2004) dir. Giulio Manfredonia","2004","Groundhog Day (1993) dir. Harold Ramis",1993,11
"183",183,"Ellam Avan Seyal (2008) dir. Shaji Kailas","2008","Chinthamani Kolacase (2006) dir. Shaji Kailas",2006,2
"184",184,"Endless Love (2014) dir. Shana Feste","2014","Endless Love (1981) dir. Franco Zeffirelli
Based on the novel by Scott Spencer",1981,33
"185",185,"Escapade (1935) dir. Robert Z. Leonard","1935","Maskerade (1934) dir. Willi Forst",1934,1
"186",186,"Evil Dead (2013) dir. Fede Alvarez","2013","The Evil Dead (1981) dir. Sam Raimi",1981,32
"187",187,"The Eye (2008) dir. David Moreau & Xavier Palud","2008","The Eye (2002) dir. Oxide Pang & Danny Pang",2002,6
"188",188,"Excursion to the Moon (1908) dir. Segundo de Chom�_n","1908","A Trip to the Moon (1902) dir. Georges M̩li̬s",1902,6
"189",189,"The Ten Commandments (1956) dir. Cecil B. Demille","1956","The Ten Commandments (1923) dir. Cecil B. Demille",1923,33
"190",190,"Exodus: Gods and Kings (2016) dir. Ridley Scott","2016","The Ten Commandments (1923) dir. Cecil B. Demille",1923,93
"191",191,"The Experiment (2010) dir. Paul Scheuring","2010","Das Experiment (2001) dir. Oliver Hirschbiegel",2001,9
"192",192,"Fame (2009) dir. Kevin Tancharoen","2009","Fame (1980) dir. Alan Parker",1980,29
"193",193,"Fatal Attraction (1987) dir. Adrian Lyne","1987","Diversion (1980) dir. James Dearden",1980,7
"194",194,"Father of the Bride (1991) dir. Charles Shyer","1991","Father of the Bride (1950) dir. Vincente Minnelli
Based on the novel by Edward Streeter",1950,41
"195",195,"Fathers' Day (1997) dir. Ivan Reitman","1997","Les Comp̬res (1983) dir. Francis Veber",1983,14
"196",196,"FC Venus (2006) dir. Ute Wieland","2006","FC Venus (2005) dir. Joona Tena",2005,1
"197",197,"The Fiend Who Walked the West (1958) dir. Gordon Douglas","1958","Kiss of Death (1947) dir. Henry Hathaway",1947,11
"198",198,"The Firm (2009) dir. Nick Love","2009","The Firm (1988) dir. Alan Clarke",1988,21
"199",199,"A Fistful of Dollars/Per un pugno di dollari (1964) dir. Sergio Leone","1964","Yojimbo (1961) dir. Akira Kurosawa",1961,3
"200",200,"Back from Eternity (1956) dir. John Farrow","1956","Five Came Back (1939) dir. John Farrow",1939,17
"201",201,"Los que volvieron (1948) dir. Alejandro Galindo","1948","Five Came Back (1939) dir. John Farrow",1939,9
"202",202,"Flatliners (2017) dir. Niels Arden Oplev","2017","Flatliners (1990) dir. Joel Schumacher",1990,27
"203",203,"The Defiant Ones (1986) dir. David Lowell Rich","1986","The Defiant Ones (1958) dir. Stanley Kramer",1958,28
"204",204,"Fled (1996) dir. Kevin Hooks","1996","The Defiant Ones (1958) dir. Stanley Kramer",1958,38
"205",205,"Flight of the Phoenix (2004) dir. John Moore","2004","The Flight of the Phoenix (1965) Robert Aldrich
Based on the novel by Elleston Trevor",1965,39
"206",206,"Flipper (1996) dir. Alan Shapiro","1996","Flipper (1963) dir. James B. Clark",1963,33
"207",207,"Floating Weeds (1959) dir. Yasujir�� Ozu","1959","A Story of Floating Weeds (1934) dir. Yasujir�� Ozu",1934,25
"208",208,"Flubber (1997) dir. Les Mayfield","1997","The Absent-Minded Professor (1961) dir. Robert Stevenson",1961,36
"209",209,"The Fly (1986) dir. David Cronenberg","1986","The Fly (1958) dir. Kurt Neumann",1958,28
"210",210,"The Fog (2005) dir. Rupert Wainwright","2005","The Fog (1980) dir. John Carpenter",1980,25
"211",211,"Footloose (2011) dir. Craig Brewer","2011","Footloose (1984) dir. Herbert Ross",1984,27
"212",212,"Forbidden Fruit (1921) dir. Cecil B. DeMille","1921","The Golden Chance (1915) dir. Cecil B. DeMille",1915,6
"213",213,"Four Sons (1940) dir. Archie Mayo","1940","Four Sons (1928) dir. John Ford",1928,12
"214",214,"Freaky Friday (1995) dir. Melanie Mayron","1995","Freaky Friday (1976) dir. Gary Nelson
Based on the novel by Mary Rodgers",1976,19
"215",215,"Freaky Friday (2003) dir. Mark Waters","2003","Freaky Friday (1976) dir. Gary Nelson
Based on the novel by Mary Rodgers",1976,27
"216",216,"Free State of Jones (2016) dir. Gary Ross","2016","Tap Roots (1948) dir. George Marshall",1948,68
"217",217,"Friday the 13th (2009) dir. Marcus Nispel","2009","Friday the 13th (1980) dir. Sean S. Cunningham",1980,29
"218",218,"Fright Night (2011) dir. Craig Gillespie","2011","Fright Night (1985) dir. Tom Holland",1985,26
"219",219,"The Front Page (1974) dir. Billy Wilder","1974","The Front Page (1931) dir. Lewis Milestone",1931,43
"220",220,"Fun with Dick and Jane (2005) dir. Dean Parisot","2005","Fun with Dick and Jane (1977) dir. Ted Kotcheff",1977,28
"221",221,"Funny Games (2008) dir. Michael Haneke","2008","Funny Games (1997) dir. Michael Haneke",1997,11
"222",222,"Waterloo Bridge (1940) dir. Mervyn LeRoy","1940","Waterloo Bridge (1931) dir. James Whale
Based on the play by Robert E. Sherwood",1931,9
"223",223,"Gaby (1956) dir. Curtis Bernhardt","1956","Waterloo Bridge (1931) dir. James Whale
Based on the play by Robert E. Sherwood",1931,25
"224",224,"Gambit (2012) dir. Michael Hoffman","2012","Gambit (1966) dir. Ronald Neame",1966,46
"225",225,"The Gambler (2014) dir. Rupert Wyatt","2014","The Gambler (1974) dir. Karel Reisz
Based upon the short novel by Fyodor Dostoyevsky",1974,40
"226",226,"Gaslight (1944) dir. George Cukor","1944","Gaslight (1940) dir. Thorold Dickinson",1940,4
"227",227,"Get Carter (2000) dir. Stephen Kay","2000","Get Carter (1971) dir. Mike Hodges",1971,29
"228",228,"The Girl Downstairs (1938) dir. Norman Taurog","1938","Catherine the Last (1936) dir. Henry Koster",1936,2
"229",229,"Gharshana (2004) dir. Gautham Menon","2004","Kaakha Kaakha (2003) dir. Gautham Menon",2003,1
"230",230,"Ghostbusters (2016) dir. Paul Feig","2016","Ghostbusters (1984) dir. Ivan Reitman",1984,32
"231",231,"Ghost Theater (2015) dir. Hideo Nakata","2015","Don't Look Up (1996) dir. Hideo Nakata",1996,19
"232",232,"Gloria (1999) dir. Sidney Lumet","1999","Gloria (1980) dir. John Cassavetes",1980,19
"233",233,"Godzilla (1998) dir. Roland Emmerich","1998","Gojira (1954) dir. Ishir�� Honda",1954,44
"234",234,"Godzilla (2014) dir. Gareth Edwards","2014","Gojira (1954) dir. Ishir�� Honda",1954,60
"235",235,"Going in Style (2017) dir. Zach Braff","2017","Going in Style (1979) dir. Martin Brest",1979,38
"236",236,"Gone in 60 Seconds (2000) dir. Dominic Sena","2000","Gone in 60 Seconds (1974) dir. H. B. Halicki",1974,26
"237",237,"The Goodbye Girl (2004) dir. Richard Benjamin","2004","The Goodbye Girl (1977) dir. Herbert Ross",1977,27
"238",238,"The Good Companions (1957) dir. J. Lee Thompson","1957","The Good Companions (1933) dir. Victor Saville",1933,24
"239",239,"Good Morning (1959) dir. Yasujir�� Ozu","1959","I Was Born, But... (1932) dir. Yasujir�� Ozu",1932,27
"240",240,"The Good Thief (2002) dir. Neil Jordan","2002","Bob le flambeur (1956) dir. Jean-Pierre Melville",1956,46
"241",241,"Gordon of Ghost City (1933) dir. Ray Taylor","1933","Flaming Guns (1932) dir. Arthur Rosson",1932,1
"242",242,"The Great Train Robbery (1904) dir. Siegmund Lubin","1904","The Great Train Robbery (1903) dir. Edwin S. Porter",1903,1
"243",243,"The Grudge (2004) dir. Takashi Shimizu","2004","Ju-on: The Grudge (2003) dir. Takashi Shimizu",2003,1
"244",244,"Guess Who (2005) dir. Kevin Rodney Sullivan","2005","Guess Who's Coming to Dinner (1967) dir. Stanley Kramer",1967,38
"245",245,"Halloween (2007) dir. Rob Zombie","2007","Halloween (1978) dir. John Carpenter",1978,29
"246",246,"The Hand (1981) dir. Oliver Stone","1981","The Beast with Five Fingers (1946) dir. Robert Florey",1946,35
"247",247,"Happy New Year (1987) dir. John G. Avildsen","1987","La bonne ann̩e (1973) dir. Claude Lelouch",1973,14
"248",248,"Hara-Kiri: Death of a Samurai (2011) dir. Takashi Miike","2011","Harakiri (1962) dir. Masaki Kobayashi",1962,49
"249",249,"The Hasty Heart (1983) dir. Martin M. Speer","1983","The Hasty Heart (1949) dir. Vincent Sherman",1949,34
"250",250,"Haunted Gold (1932) dir. Mack V. Wright","1932","The Phantom City (1928) dir. Albert S. Rogell",1928,4
"251",251,"The Haunting (1999) dir. Jan de Bont","1999","The Haunting (1963) dir. Robert Wise",1963,36
"252",252,"Head Above Water (1996) dir. Jim Wilson","1996","Hodet over vannet (1993) dir. Nils Gaup",1993,3
"253",253,"The Heartbreak Kid (2007) dir. Bobby Farrelly & Peter Farrelly","2007","The Heartbreak Kid (1972) dir. Elaine May
Based on the short story A Change of Plan by Bruce Jay Friedman",1972,35
"254",254,"Heat (1995) dir. Michael Mann","1995","L.A. Takedown (1989) dir. Michael Mann",1989,6
"255",255,"Her Majesty, Love (1931) dir. William Dieterle","1931","Her Majesty the Barmaid (1931) dir. Joe May",1931,0
"256",256,"Outland (1981) dir. Peter Hyams","1981","High Noon (1952) dir. Fred Zinnemann",1952,29
"257",257,"High Noon (2000) dir. Rod Hardy","2000","High Noon (1952) dir. Fred Zinnemann",1952,48
"258",258,"High Society (1956) dir. Charles Walters","1956","The Philadelphia Story (1940) dir. George Cukor",1940,16
"259",259,"The Hills Have Eyes (2006) dir. Alexandre Aja","2006","The Hills Have Eyes (1977) dir. Wes Craven",1977,29
"260",260,"The Hitcher (2007) dir. Dave Meyers","2007","The Hitcher (1986) dir. Robert Harmon",1986,21
"261",261,"Holiday (1938) dir. George Cukor","1938","Holiday (1930) dir. Edward H. Griffith",1930,8
"262",262,"Homeward Bound: The Incredible Journey (1993) dir. Duwayne Dunham","1993","The Incredible Journey (1963) dir. Fletcher Markle
Based on the novel by Sheila Burnford",1963,30
"263",263,"Hoodman Blind (1923) dir. John Ford","1923","Hoodman Blind (1913) dir. James Gordon",1913,10
"264",264,"House on Haunted Hill (1999) dir. William Malone","1999","House on Haunted Hill (1959) dir. William Castle",1959,40
"265",265,"House of Wax (1953) dir. Andr̩ de Toth","1953","Mystery of the Wax Museum (1933) dir. Michael Curtiz",1933,20
"266",266,"House of Wax (2005) dir. Jaume Collet-Serra","2005","Mystery of the Wax Museum (1933) dir. Michael Curtiz",1933,72
"267",267,"How to Make a Monster (2001) dir. George Huang","2001","How to Make a Monster (1958) dir. Herbert L. Strock",1958,43
"268",268,"Huckleberry Finn (1974) dir. J. Lee Thompson","1974","The Adventures of Huckleberry Finn (1939) dir. Richard Thorpe",1939,35
"269",269,"Hurricane (1979) dir. Jan Troell","1979","The Hurricane (1937) dir. John Ford
Based on the novel by Charles Nordhoff and James Norman Hall",1937,42
"270",270,"The Omega Man (1971) dir. Boris Sagal","1971","The Last Man on Earth (1964) dir. Ubaldo Ragona and Sidney Salkow
Based on the novel I Am Legend by Richard Matheson",1964,7
"271",271,"tI Am Legend (2007) dir. Francis Lawrence","2007","The Last Man on Earth (1964) dir. Ubaldo Ragona and Sidney Salkow
Based on the novel I Am Legend by Richard Matheson",1964,43
"272",272,"I Am Omega (2007) dir. Griff Furs","2007","The Last Man on Earth (1964) dir. Ubaldo Ragona and Sidney Salkow
Based on the novel I Am Legend by Richard Matheson",1964,43
"273",273,"I Died A Thousand Times (1955) dir. Stuart Heisler","1955","High Sierra (1941) dir. Raoul Walsh",1941,14
"274",274,"I Married a Monster (1998) dir. Nancy Malone","1998","I Married a Monster from Outer Space (1958) dir. Gene Fowler Jr.",1958,40
"275",275,"I Saw What You Did (1988) dir. Fred Walton","1988","I Saw What You Did (1965) dir. William Castle",1965,23
"276",276,"I Spit on Your Grave (2010) dir. Steven R. Monroe","2010","I Spit on Your Grave (1978) dir. Meir Zarchi",1978,32
"277",277,"I Want to Live! (1983) dir. David Lowell Rich","1983","I Want to Live! (1958) dir. Robert Wise",1958,25
"278",278,"Ice Castles (2010) dir. Donald Wrye","2010","Ice Castles (1978) dir. Donald Wrye",1978,32
"279",279,"Ihr erstes Rendezvous (1955) dir. Axel von Ambesser","1955","Premier rendez-vous (1941) dir. Henri Decoin",1941,14
"280",280,"In the Good Old Summertime (1949) dir. Robert Z. Leonard","1949","The Shop Around the Corner (1940) dir. Ernst Lubitsch",1940,9
"281",281,"Indiscretion of an American Wife (1998) dir. George Kaczender","1998","Terminal Station (1953) dir. Vittorio De Sica",1953,45
"282",282,"The Initiation of Sarah (2006) dir. Stuart Gillard","2006","The Initiation of Sarah (1978) dir. Robert Day",1978,28
"283",283,"The In-Laws (2003) dir. Andrew Fleming","2003","The In-Laws (1979) dir. Arthur Hiller",1979,24
"284",284,"Insomnia (2002) dir. Christopher Nolan","2002","Insomnia (1997) dir. Erik Skjoldbj�_rg",1997,5
"285",285,"Intersection (1994) dir. Mark Rydell","1994","Les choses de la vie (1970) dir. Claude Sautet",1970,24
"286",286,"Intermezzo (1939) dir. Gregory Ratoff","1939","Intermezzo (1936) dir. G̦sta Stevens",1936,3
"287",287,"Interview (2007) dir. Steve Buscemi","2007","Interview (2003) dir. Theo van Gogh",2003,4
"288",288,"Invaders from Mars (1986) dir. Tobe Hooper","1986","Invaders from Mars (1953) dir. William Cameron Menzies",1953,33
"289",289,"Invasion of the Body Snatchers (1978) dir. Philip Kaufman","1978","Invasion of the Body Snatchers (1956) dir. Don Siegel",1956,22
"290",290,"Body Snatchers (1993) dir. Abel Ferrara","1993","Invasion of the Body Snatchers (1956) dir. Don Siegel",1956,37
"291",291,"The Invasion (2007) dir. Oliver Hirschbiegel","2007","Invasion of the Body Snatchers (1956) dir. Don Siegel",1956,51
"292",292,"Irma la Douce (1972) dir. Paul Paviot","1972","Irma la Douce (1963) dir. Billy Wilder",1963,9
"293",293,"Iron Maze (1991) dir. Hiroaki Yoshida","1991","Rashomon (1950) dir. Akira Kurosawa",1950,41
"294",294,"The Italian Job (2003) dir. F. Gary Gray","2003","The Italian Job (1969) dir. Peter Collinson",1969,34
"295",295,"�Le Golem (1936) dir. Julien Duvivier","1936","The Golem (1920) dir. Paul Wegener",1920,16
"296",296,"The Emperor and the Golem (1951) dir. Martin Fri�","1951","The Golem (1920) dir. Paul Wegener",1920,31
"297",297,"It! (1967) dir. Herbert J. Leder","1967","The Golem (1920) dir. Paul Wegener",1920,47
"298",298,"It's Alive (2009) dir. Josef Rusnak","2009","It's Alive (1974) dir. Larry Cohen",1974,35
"299",299,"It's Great to Be Alive (1933) dir. Alfred L. Werker","1933","The Last Man on Earth (1924) dir. John G. Blystone",1924,9
"300",300,"J'accuse (1938) dir. Abel Gance","1938","J'accuse (1919) dir. Abel Gance",1919,19
"301",301,"The Jackal (1997) dir. Michael Caton-Jones","1997","The Day of the Jackal (1973) dir. Fred Zinnemann
Based on the novel by Frederick Forsyth",1973,24
"302",302,"Jakob the Liar (1999) dir. Peter Kassovitz","1999","Jacob the Liar (1975) dir. Frank Beyer",1975,24
"303",303,"The Jazz Singer (1952) dir. Michael Curtiz","1952","The Jazz Singer (1927) dir. Alan Crosland
Based on the play by Samson Raphaelson",1927,25
"304",304,"The Jazz Singer (1980) dir. Richard Fleischer","1980","The Jazz Singer (1927) dir. Alan Crosland
Based on the play by Samson Raphaelson",1927,53
"305",305,"Jigoku (1999) dir. Teruo IshiiJigoku (1970) dir. Tatsumi Kumashiro","1999","Jigoku (1960) dir. Nobuo Nakagawa",1960,39
"306",306,"Journey into Fear (1975) dir. Daniel Mann","1975","Journey into Fear (1943) dir. Norman Foster
Based on the novel by Eric Ambler",1943,32
"307",307,"The Jungle Book (2016) dir. Jon Favreau","2016","The Jungle Book (1967) dir. Wolfgang Reitherman",1967,49
"308",308,"The Jungle Book: Mowgli's Story (1998)","1998","The Jungle Book (1967) dir. Wolfgang Reitherman",1967,31
"309",309,"Rudyard Kipling's The Jungle Book (1994)","1994","The Jungle Book (1967) dir. Wolfgang Reitherman",1967,27
"310",310,"Jungle 2 Jungle (1997) dir. John Pasquin","1997","Un indien dans la ville (1994) dir. Herv̩ Palud",1994,3
"311",311,"Juno and the Paycock (1980) dir. Roger Cheveley","1980","Juno and the Paycock (1930) dir. Alfred Hitchcock",1930,50
"312",312,"Just Visiting (2001) dir. Jean-Marie Poir̩","2001","Les Visiteurs (1993) dir. Jean-Marie Poir̩",1993,8
"313",313,"Nihon Chinbotsu (2006) dir. Shinji Higuchi","2006","Nihon Chinbotsu (1973) dir. Shir̫ Moritani",1973,33
"314",314,"The Karate Kid (2010) dir. Harald Zwart","2010","The Karate Kid (1984) dir. John G. Avildsen",1984,26
"315",315,"The Kid from Brooklyn (1946) dir. Norman Z. McLeod","1946","The Milky Way (1936) dir. Leo McCarey",1936,10
"316",316,"King Kong (1976) dir. John Guillermin","1976","King Kong (1933) dir. Merian C. Cooper & Ernest B. Schoedsack",1933,43
"317",317,"King Kong (2005) dir. Peter Jackson","2005","King Kong (1933) dir. Merian C. Cooper & Ernest B. Schoedsack",1933,72
"318",318,"King Solomon's Mines (2004) dir Steve Boyum","2004","King Solomon's Mines (1937) dir. Robert Stevenson",1937,67
"319",319,"King Solomon's Mines (1985) dir. J. Lee Thompson","1985","King Solomon's Mines (1937) dir. Robert Stevenson",1937,48
"320",320,"King Solomon's Mines (1950) dir. Compton Bennett & Andrew Marton","1950","King Solomon's Mines (1937) dir. Robert Stevenson",1937,13
"321",321,"A Connecticut Yankee (1931) dir David Butler","1931","A Connecticut Yankee in King Arthur's Court (1921) dir. Emmett J. Flynn",1921,10
"322",322,"A Connecticut Yankee in King Arthur's Court (1949) dir. Tay Garnett","1949","A Connecticut Yankee in King Arthur's Court (1921) dir. Emmett J. Flynn",1921,28
"323",323,"A Kid in King Arthur's Court (1995) dir. Michael Gottlieb","1995","A Connecticut Yankee in King Arthur's Court (1921) dir. Emmett J. Flynn",1921,74
"324",324,"A Kiss Before Dying (1991) dir. James Dearden","1991","A Kiss Before Dying (1956) dir. Gerd Oswald
Based on the novel by Ira Levin",1956,35
"325",325,"Kiss Me Goodbye (1982) dir. Robert Mulligan","1982","Dona Flor e Seus Dois Maridos (1976) dir. Bruno Barreto",1976,6
"326",326,"The Fiend Who Walked the West (1958) dir. Gordon Douglas","1958","Kiss of Death (1947) dir. Henry Hathaway",1947,11
"327",327,"Kiss of Death (1995) dir. Barbet Schroeder","1995","Kiss of Death (1947) dir. Henry Hathaway",1947,48
"328",328,"Knock Knock (2015) dir. Eli Roth","2015","Death Game (1977) dir. Peter S. Traynor",1977,38
"329",329,"Korei (2000) dir Kiyoshi Kurosawa","2000","S̩ance on a Wet Afternoon (1964) dir. Bryan Forbes",1964,36
"330",330,"The Ladykillers (2004) dir. Coen brothers","2004","The Ladykillers (1955) dir. Alexander Mackendrick",1955,49
"331",331,"The Lady Vanishes (1979) dir. Anthony Page","1979","The Lady Vanishes (1938) dir. Alfred Hitchcock",1938,41
"332",332,"The Land That Time Forgot (2009) dir. C. Thomas Howell","2009","The Land That Time Forgot (1975) dir. Kevin Connor
Based on the 1918 novel of the same name by Edgar Rice Burroughs",1975,34
"333",333,"The Lake House (2006) dir. Alejandro Agresti","2006","Il Mare (2000) dir. Lee Hyun-seung",2000,6
"334",334,"Last Holiday (2006) dir. Wayne Wang","2006","Last Holiday (1950) dir. Henry Cass",1950,56
"335",335,"The Last House on the Left (1972) dir. Wes Craven","1972","The Virgin Spring (1960) dir. Ingmar Bergman",1960,12
"336",336,"The Last House on the Left (2009) dir. Dennis Iliadis","2009","The Virgin Spring (1960) dir. Ingmar Bergman",1960,49
"337",337,"The Last Kiss (2006) dir. Tony Goldwyn","2006","L'ultimo bacio (2001)",2001,5
"338",338,"Last Man Standing (1996) dir. Walter Hill","1996","Yojimbo (1961) dir. Akira Kurosawa",1961,35
"339",339,"The Last of Mrs. Cheyney (1937) dir. Richard Boleslawski and Dorothy Arzner","1937","The Last of Mrs. Cheyney (1929) dir. Sidney Franklin",1929,8
"340",340,"Laughing Gravy (1931) dir. James W. Horne","1931","Angora Love (1929) dir. Lewis R. Foster",1929,2
"341",341,"Let Me In (2010) dir. Matt Reeves","2010","Let The Right One In (2008) dir. Tomas Alfredson
Based on the 2004 novel Let the Right One In by John Ajvide Lindqvist",2008,2
"342",342,"Easy to Wed (1946) dir. Edward Buzzell","1946","Libeled Lady (1936) dir. Jack Conway",1936,10
"343",343,"Lifepod (1993) dir. Ron Silver","1993","Lifeboat (1944) dir. Alfred Hitchcock",1944,49
"344",344,"The Little Foxes (1956) dir. George Schaefer","1956","The Little Foxes (1941) dir. William Wyler",1941,15
"345",345,"Little Fugitive (2006) dir. Joanna Lipper","2006","Little Fugitive (1953) dir. Ray Ashley",1953,53
"346",346,"Sorrowful Jones (1949) dir. Sidney Lanfield","1949","Little Miss Marker (1934) dir. Alexander Hall
Based on a short story by Damon Runyon",1934,15
"347",347,"Little Miss Marker (1980) dir. Walter Bernstein","1980","Little Miss Marker (1934) dir. Alexander Hall
Based on a short story by Damon Runyon",1934,46
"348",348,"Little Shop of Horrors (1986) dir. Frank Oz","1986","Little Shop of Horrors (1960) dir. Roger Corman",1960,26
"349",349,"The Lodger (2009) dir. David Ondaatje","2009","The Lodger (1927) dir. Alfred Hitchcock",1927,82
"350",350,"Man in the Attic (1953) dir. Hugo Fregonese","1953","The Lodger (1927) dir. Alfred Hitchcock",1927,26
"351",351,"The Lodger (1944) dir. John Brahm","1944","The Lodger (1927) dir. Alfred Hitchcock",1927,17
"352",352,"The Lodger (1932) dir. Maurice Elvey","1932","The Lodger (1927) dir. Alfred Hitchcock",1927,5
"353",353,"Loft (2010) dir. Antoinette Beumer","2010","Loft (2008) dir. Erik Van Looy",2008,2
"354",354,"The Loft (2014) dir. Erik Van Looy","2014","Loft (2008) dir. Erik Van Looy",2008,6
"355",355,"LOL (2012) dir. Lisa Azuelos","2012","LOL (Laughing Out Loud) (2008) dir. Lisa Azuelos",2008,4
"356",356,"Mean Machine (2001) dir. Barry Skolnick","2001","The Longest Yard (1974) dir. Robert Aldrich",1974,27
"357",357,"The Longest Yard (2005) dir. Peter Segal","2005","The Longest Yard (1974) dir. Robert Aldrich",1974,31
"358",358,"Long Fliv the King (1926) dir. Leo McCarey","1926","His Royal Slyness (1920) dir. Hal Roach",1920,6
"359",359,"The Long Hot Summer (1985) dir. Stuart Cooper","1985","The Long, Hot Summer (1958) dir. Martin Ritt",1958,27
"360",360,"The Long Night (1947) dir. Anatole Litvak","1947","Le Jour se l̬ve (1939) dir. Marcel Carn̩",1939,8
"361",361,"Lost Horizon (1973) dir. Charles Jarrott","1973","Lost Horizon (1937) dir. Frank Capra",1937,36
"362",362,"The Lost Patrol (1934) dir. John Ford","1934","Lost Patrol (1929) dir. Walter Summers",1929,5
"363",363,"An Affair to Remember (1957) dir. Leo McCarey","1957","Love Affair (1939) dir. Leo McCarey",1939,18
"364",364,"Love Affair (1994) dir. Glenn Gordon Caron","1994","Love Affair (1939) dir. Leo McCarey",1939,55
"365",365,"Love Don't Cost a Thing (2003) dir. Troy Beyer","2003","Can�۪t Buy Me Love (1987) dir. Steve Rash",1987,16
"366",366,"Lure of the Wilderness (1952) dir. Jean Negulesco","1952","Swamp Water (1941) dir. Jean Renoir",1941,11
"367",367,"M (1951) dir. Joseph Losey","1951","M (1931) dir. Fritz Lang",1931,20
"368",368,"M�_dchen in Uniform (1958) dir. G̩za von Radv��nyi","1958","M�_dchen in Uniform (1931) dir. Leontine Sagan",1931,27
"369",369,"The Magnificent Ambersons (1942) dir. Orson Welles","1942","Pampered Youth (1925) dir. David Smith",1925,17
"370",370,"The Magnificent Ambersons (2002) dir. Alfonso Arau","2002","Pampered Youth (1925) dir. David Smith",1925,77
"371",371,"The Magnificent Seven (1960) dir. John Sturges","1960","Seven Samurai (1954) dir. Akira Kurosawa",1954,6
"372",372,"Main Aisa Hi Hoon (2005) dir. Harry Baweja","2005","I Am Sam (2001) dir. Jessie Nelson",2001,4
"373",373,"Major Payne (1995) dir. Nick Castle","1995","The Private War of Major Benson (1955) dir. Jerry Hopper",1955,40
"374",374,"Satan Met a Lady (1936) dir. William Dieterle","1936","The Maltese Falcon (1931) dir. Roy Del Ruth",1931,5
"375",375,"The Maltese Falcon (1941) dir. John Huston","1941","The Maltese Falcon (1931) dir. Roy Del Ruth",1931,10
"376",376,"The Man They Could Not Hang (1939) dir. Nick Grinde","1939","The Walking Dead (1936) dir. Michael Curtiz",1936,3
"377",377,"The Man with One Red Shoe (1985) dir. Stan Dragoti","1985","Le Grand Blond avec une chaussure noire (1972) dir. Yves Robert",1972,13
"378",378,"The Man Without a Country (1937) dir. Crane Wilbur","1937","The Man Without a Country (1917) dir. Ernest C. Warde",1917,20
"379",379,"The Man Who Knew Too Much (1956) dir. Alfred Hitchcock","1956","The Man Who Knew Too Much (1934) dir. Alfred Hitchcock",1934,22
"380",380,"The Man Who Loved Women (1983) dir. Blake Edwards","1983","The Man Who Loved Women (1977) dir. Fran̤ois Truffaut",1977,6
"381",381,"The Manchurian Candidate (2004) dir. Jonathan Demme","2004","The Manchurian Candidate (1962) dir. John Frankenheimer",1962,42
"382",382,"Apthamitra (2004) dir. P. Vasu","2004","Manichitrathazhu (1993) dir. Fazil",1993,11
"383",383,"Chandramukhi (2005) dir. P. Vasu","2005","Manichitrathazhu (1993) dir. Fazil",1993,12
"384",384,"Rajmohol (2005) dir. Sapan Saha","2005","Manichitrathazhu (1993) dir. Fazil",1993,12
"385",385,"Bhool Bhulaiyaa (2007) dir. Priyadarshan","2007","Manichitrathazhu (1993) dir. Fazil",1993,14
"386",386,"Marcellino (1991) dir. Luigi Comencini","1991","Marcelino Pan y Vino (1955) dir. Ladislao Vajda",1955,36
"387",387,"Marcelino Pan y Vino (1979, made-for-TV) dir. Mario O'Hara",1979,"Marcelino Pan y Vino (1955) dir. Ladislao Vajda",1955,24
"388",388,"Le Mari r̻v̩��(fr) (1936) dir. Roger Capellani","1936","Life Is a Dog (1933) dir. Martin Fri��",1933,3
"389",389,"Marilyn Hotchkiss' Ballroom Dancing and Charm School (2005) dir. Randall Miller","2005","Marilyn Hotchkiss' Ballroom Dancing and Charm School (1990)",1990,15
"390",390,"Mark of the Vampire (1935) dir. Tod Browning","1935","London After Midnight (1927) dir. Tod Browning",1927,8
"391",391,"Marked Men (1919) dir. John Ford","1919","The Three Godfathers (1916) dir. Edward LeSaint",1916,3
"392",392,"Martyrs (2015) dir. Kevin and Michael Goetz","2015","Martyrs (2008) dir. Pascal Laugier",2008,7
"393",393,"The Mask of Fu Manchu (1932) dir. Charles Brabin","1932","The Mysterious Dr. Fu Manchu (1929) dir. Rowland V. Lee",1929,3
"394",394,"Masquerade in Mexico (1945) dir. Mitchell Leisen","1945","Midnight (1939) dir. Mitchell Leisen",1939,6
"395",395,"The Mechanic (2011) dir. Simon West","2011","The Mechanic (1972) dir. Michael Winner",1972,39
"396",396,"Meet Joe Black (1998) dir. Martin Brest","1998","Death Takes a Holiday (1934) dir. Mitchell Leisen
Based on the play by Alberto Casella",1934,64
"397",397,"Meet Me in St. Louis (1959) dir. George Schaefer","1959","Meet Me in St. Louis (1944) dir. Vincente Minnelli",1944,15
"398",398,"Meet Me in St. Louis (1966) dir. Alan D. Courtney","1966","Meet Me in St. Louis (1944) dir. Vincente Minnelli",1944,22
"399",399,"Men Don't Leave (1990) dir. Paul Brickman","1990","La vie continue (1981) dir. Mosh̩ Mizrahi",1981,9
"400",400,"It Happened One Christmas (1977) dir. Donald Wrye","1977","It's a Wonderful Life (1946) dir. Frank Capra",1946,31
"401",401,"Merry Christmas George Bailey (1997) dir. Matthew Diamond","1997","It's a Wonderful Life (1946) dir. Frank Capra",1946,51
"402",402,"Messenger (1994) dir. Norman Loftis","1994","Bicycle Thieves (1948) dir. Vittorio De Sica",1948,46
"403",403,"Mighty Joe Young (1998) dir. Ron Underwood","1998","Mighty Joe Young (1949) dir. Ernest B. Schoedsack",1949,49
"404",404,"Miracle on 34th Street (1973) dir. Fielder CookThe Miracle on 34th Street (1955) dir. Robert Stevenson","1973","Miracle on 34th Street (1947) dir. George Seaton",1947,26
"405",405,"Miracle on 34th Street (1994) dir. Les Mayfield","1994","Miracle on 34th Street (1947) dir. George Seaton",1947,47
"406",406,"The Miracle Man (1932) dir. Norman Z. McLeod","1932","The Miracle Man (1919) dir. George Loane Tucker",1919,13
"407",407,"The Mirror Has Two Faces (1996) dir. Barbra Streisand","1996","Le Mariage a Deux Faces (1959) dir. Andr̩ Cayatte",1959,37
"408",408,"Mirrors (2008) dir. Alexandre AjaMirrors 2 (2010) dir. V�_ctor Garc�_a","2008","Into the Mirror (2003) dir. Sung-ho Kim",2003,5
"409",409,"20 Once Again (2015) dir. Leste Chen","2015","Miss Granny (2014) dir. Hwang Dong-hyuk",2014,1
"410",410,"Missile to the Moon (1958) dir. Richard E. Cunha","1958","Cat-Women of the Moon (1953) dir. Arthur Hilton",1953,5
"411",411,"Mixed Nuts (1994) dir. Nora Ephron","1994","Le P̬re No��l est une ordure (1982) dir. Jean-Marie Poir̩",1982,12
"412",412,"Mogambo (1953) dir. John Ford","1953","Red Dust (1932) dir. Victor Fleming",1932,21
"413",413,"The Money Pit (1986) dir. Richard Benjamin","1986","Mr. Blandings Builds His Dream House (1948) dir. H. C. Potter",1948,38
"414",414,"The Monkey's Paw (1948) dir. Norman Lee","1948","The Monkey's Paw (1933) dir. Ernest B. Schoedsack",1933,15
"415",415,"The Monster and the Girl (1941) dir. Stuart Heisler","1941","Go and Get It (1920) dir. Marshall Neilan",1920,21
"416",416,"Moon Over Parador (1988) dir. Paul Mazursky","1988","The Magnificent Fraud (1939) dir. Robert Florey",1939,49
"417",417,"Mother's Day (2010) dir. Darren Lynn Bousman","2010","Mother's Day (1980) dir. Charles Kaufman",1980,30
"418",418,"Something's Got to Give (unfinished) (1962) dir. George Cukor","1962","My Favorite Wife (1940) dir. Garson Kanin",1940,22
"419",419,"Move Over, Darling (1963) dir. Michael Gordon","1963","My Favorite Wife (1940) dir. Garson Kanin",1940,23
"420",420,"Mr. Deeds (2002) dir. Steven Brill","2002","Mr. Deeds Goes to Town (1936) dir. Frank Capra",1936,66
"421",421,"The Mummy (1999) dir. Stephen Sommers","1999","The Mummy (1932) dir. Karl Freund",1932,67
"422",422,"Vasool Raja MBBS (2006) dir. Saran","2006","Munna Bhai M.B.B.S. (2003) dir. Rajkumar Hirani",2003,3
"423",423,"Shankar Dada MBBS (2004) dir. Jayanth C. Paranjee","2004","Munna Bhai M.B.B.S. (2003) dir. Rajkumar Hirani",2003,1
"424",424,"Uppi Dada M.B.B.S. (2006) dir. D. Rajendra Babu","2006","Munna Bhai M.B.B.S. (2003) dir. Rajkumar Hirani",2003,3
"425",425,"My Bloody Valentine 3D (2009) dir. Patrick Lussier","2009","My Bloody Valentine (1981) dir. George Mihalka",1981,28
"426",426,"My Father the Hero (1994) dir. Steve Miner","1994","Mon p̬re, ce h̩ros (1991) dir. G̩rard Lauzier",1991,3
"427",427,"My Man Godfrey (1957) dir. Henry Koster","1957","My Man Godfrey (1936) dir. Gregory La Cava",1936,21
"428",428,"My Fair Lady (1964) dir. George Cukor","1964","Pygmalion (1938) dir. Anthony Asquith and Leslie Howard",1938,26
"429",429,"My Sassy Girl (2008) dir. Yann Samuell","2008","Yeopgijeogin geunyeo (2001) dir. Jae-young Kwak",2001,7
"430",430,"Naa Autograph (2004) dir. S. Gopal Reddy","2004","Autograph (2004) dir. Cheran",2004,0
"431",431,"Naina (2005) dir. Shripal Morakhia","2005","The Eye (2002) dir. Oxide Pang",2002,3
"432",432,"Narrow Margin (1990) dir. Peter Hyams","1990","The Narrow Margin (1952) dir. Richard Fleischer",1952,38
"433",433,"The Next Three Days (2010) dir. Paul Haggis","2010","Anything for Her (2008) dir. Fred Cavay̩",2008,2
"434",434,"Night and the City (1992) dir. Irwin Winkler","1992","Night and the City (1950) dir. Jules Dassin",1950,42
"435",435,"Night Must Fall (1964) dir. Karel Reisz","1964","Night Must Fall (1937) dir. Richard Thorpe",1937,27
"436",436,"A Nightmare on Elm Street (2010) dir. Samuel Bayer","2010","A Nightmare on Elm Street (1984) dir. Wes Craven",1984,26
"437",437,"Night of the Demons (2009) dir. Adam Gierasch","2009","Night of the Demons (1988) dir. Kevin S. Tenney",1988,21
"438",438,"Night of the Living Dead (1990) dir. Tom Savini","1990","Night of the Living Dead (1968) dir. George A. Romero",1968,22
"439",439,"Night of the Living Dead 3D (2006) dir. Jeff Broadstreet","2006","Night of the Living Dead (1968) dir. George A. Romero",1968,38
"440",440,"Nightwatch (1997) dir. Ole Bornedal","1997","Nattevagten (1994) dir. Ole Bornedal",1994,3
"441",441,"Nine Months (1995) dir. Chris Columbus","1995","Neuf mois (1994) dir. Patrick Braoud̩",1994,1
"442",442,"No Reservations (2007) dir. Scott Hicks","2007","Mostly Martha (2001) dir. Sandra Nettelbeck",2001,6
"443",443,"Nosferatu (1979) dir. Werner Herzog","1979","Nosferatu (1922) dir. F.W. Murnau",1922,57
"444",444,"No Way Out (1987) dir. Roger Donaldson","1987","The Big Clock (1948) dir. John Farrow
Based on the novel by Kenneth Fearing",1948,39
"445",445,"Not of This Earth (1988) dir. Jim Wynorski","1988","Not of This Earth (1957) dir. Roger Corman",1957,31
"446",446,"Not of This Earth (1995) dir. Terence H. Winkless","1995","Not of This Earth (1957) dir. Roger Corman",1957,38
"447",447,"Notorious (1992) dir. Colin Bucksey","1992","Notorious (1946) dir. Alfred Hitchcock",1946,46
"448",448,"Rangrezz (2013) dir. Priyadarshan","2013","Naadodigal (2009) dir. Samuthirakani",2009,4
"449",449,"Run (2011) dir. Swapan Saha","2011","Naadodigal (2009) dir. Samuthirakani",2009,2
"450",450,"Ithu Nammude Katha (2011) dir. Rajesh Kannankara","2011","Naadodigal (2009) dir. Samuthirakani",2009,2
"451",451,"Hudugaru (2011) dir. Maadesh","2011","Naadodigal (2009) dir. Samuthirakani",2009,2
"452",452,"Shambo Shiva Shambo (2010) dir. Samuthirakani","2010","Naadodigal (2009) dir. Samuthirakani",2009,1
"453",453,"All the Best (2012) dir. J. D. Chakravarthy","2012","Nueve Reinas (2000) dir. Fabi��n Bielinsky",2000,12
"454",454,"Gulumaal: The Escape (2009) dir. V. K. Prakash","2009","Nueve Reinas (2000) dir. Fabi��n Bielinsky",2000,9
"455",455,"Bluffmaster! (2005) dir. Rohan Sippy","2005","Nueve Reinas (2000) dir. Fabi��n Bielinsky",2000,5
"456",456,"Criminal (2004) dir. Gregory Jacobs","2004","Nueve Reinas (2000) dir. Fabi��n Bielinsky",2000,4
"457",457,"The Nutty Professor (1996) dir. Tom Shadyac","1996","The Nutty Professor (1963) dir. Jerry Lewis",1963,33
"458",458,"Ocean's Eleven (2001) dir. Steven Soderbergh","2001","Ocean's 11 (1960) dir. Lewis Milestone",1960,41
"459",459,"Oh Jonathan ��� oh Jonathan!��(de) (1973) dir. Franz Peter Wirth","1973","It Started with Eve (1941) dir. Henry Koster",1941,32
"460",460,"The Old Dark House (1963) dir. William Castle","1963","The Old Dark House (1932) dir. James Whale",1932,31
"461",461,"Oldboy (2013) dir. Spike Lee","2013","Oldboy (2003) dir. Park Chan-wook",2003,10
"462",462,"I Am Omega (2007) dir. Griff Furst","2007","The Last Man on Earth (1964) dir. Ubaldo Ragona and Sidney Salkow
Based on the novel I Am Legend by Richard Matheson",1964,43
"463",463,"I Am Legend (2007) dir. Francis Lawrence","2007","The Last Man on Earth (1964) dir. Ubaldo Ragona and Sidney Salkow
Based on the novel I Am Legend by Richard Matheson",1964,43
"464",464,"The Omega Man (1971) dir. Boris Sagal","1971","The Last Man on Earth (1964) dir. Ubaldo Ragona and Sidney Salkow
Based on the novel I Am Legend by Richard Matheson",1964,7
"465",465,"The Omen (2006) dir. John Moore","2006","The Omen (1976) dir. Richard Donner
Based on the David Seltzer novel of the same name.",1976,30
"466",466,"On the Beach (2000) dir. Russell Mulcahy","2000","On the Beach (1959) dir. Stanley Kramer",1959,41
"467",467,"One Million Years B.C. (1966) dir. Don Chaffey","1966","One Million B.C. (1940) dir. Hal Roach & Hal Roach, Jr.",1940,26
"468",468,"One Missed Call (2007) dir. Eric Valette","2007","One Missed Call (Chakushin Ari) (2004) dir. Takashi Miike",2004,3
"469",469,"The Opposite Sex (1956) dir. David Miller","1956","The Women (1939) dir. George Cukor",1939,17
"470",470,"Orfeu (1999) dir. Carlos Diegues","1999","Black Orpheus (1959) dir. Marcel Camus",1959,40
"471",471,"Orphans of the Storm (1921) dir. D. W. Griffith","1921","The Two Orphans (1915) dir. Herbert Brenon",1915,6
"472",472,"Oscar (1991) dir. John Landis","1991","Oscar (1967) dir. ��douard Molinaro
Based on the stage play by Claude Magnier",1967,24
"473",473,"The Out-of-Towners (1999) dir. Sam Weisman","1999","The Out-of-Towners (1970) dir. Arthur Hiller",1970,29
"474",474,"Outland (1981) dir. Peter Hyams","1981","High Noon (1952) dir. Fred Zinnemann",1952,29
"475",475,"The Outrage (1964) dir. Martin Ritt","1964","Rashomon (1950) dir. Akira Kurosawa",1950,14
"476",476,"Outside the Law (1930) dir. Tod Browning","1930","Outside the Law (1920) dir. Tod Browning",1920,10
"477",477,"Oxford Blues (1984) dir. Robert Boris","1984","A Yank at Oxford (1938) dir. Jack Conway",1938,46
"478",478,"Painting the Clouds with Sunshine (1951) dir. David Butler","1951","Gold Diggers of 1933 (1933) dir. Mervyn LeRoy",1933,18
"479",479,"Paradise (1991) dir. Mary Agnes Donoghue","1991","Le grand chemin (1987) dir. Jean-Loup Hubert",1987,4
"480",480,"The Parent Trap (1998) dir. Nancy Meyers","1998","The Parent Trap (1961) dir. David Swift
Based on the book Das doppelte Lottchen by Erich K�_stner",1961,37
"481",481,"Paris, When It Sizzles (1964) dir. Richard Quine","1964","Holiday for Henrietta (1952) dir. Julien Duvivier",1952,12
"482",482,"Pathfinder (2006) dir. Marcus Nispel","2006","Ofelas (1987) dir. Nils Gaup",1987,19
"483",483,"Peking Express (1951) dir. William Dieterle","1951","Shanghai Express (1932) dir. Josef von Sternberg",1932,19
"484",484,"A Perfect Murder (1998) dir. Andrew Davis","1998","Dial M for Murder (1954) dir. Alfred Hitchcock
Based on the stage thriller by Frederick Knott",1954,44
"485",485,"The Phantom Carriage (1958) dir. Arne Mattsson","1958","The Phantom Carriage (1921) dir Victor Sj̦str̦m",1921,37
"486",486,"Phantom of the Opera (1943) dir. Arthur Lubin","1943","The Phantom of the Opera (1925) dir Rupert Julian",1925,18
"487",487,"Picnic (2000) dir. Ivan PasserPicnic (1986) dir. Marshall W. Mason","2000","Picnic (1955) dir. Joshua Logan",1955,45
"488",488,"""Pimpernel"" Smith (1941) dir. Leslie Howard","1941","The Scarlet Pimpernel (1934) dir. Harold Young",1934,7
"489",489,"Piranha 3-D (2010) dir. Alexandre AjaPiranha (1995) dir. Scott P. Levy","2010","Piranha (1978) dir. Joe Dante",1978,32
"490",490,"The Plainsman (1966) dir. David Lowell Rich","1966","The Plainsman (1936) dir. Cecil B. DeMille",1936,30
"491",491,"Planet of the Apes (2001) dir. Tim Burton","2001","Planet of the Apes (1968) dir. Franklin J. Schaffner
Based on the novel by Pierre Boulle",1968,33
"492",492,"The Plank (1979) dir. Eric Sykes","1979","The Plank (1967) dir. Eric Sykes",1967,12
"493",493,"Pocketful of Miracles (1961) dir. Frank Capra","1961","Lady for a Day (1933) dir. Frank Capra",1933,28
"494",494,"Point Break (2015) dir. Ericson Core","2015","Point Break (1991) dir. Kathryn Bigelow",1991,24
"495",495,"Point of No Return (1993) dir. John Badham","1993","La Femme Nikita (1990) dir. Luc Besson",1990,3
"496",496,"Poltergeist (2015) dir. Gil Kenan","2015","Poltergeist (1982) dir. Tobe Hooper",1982,33
"497",497,"Pokkiri (2007) dir. Prabhu Deva","2007","Pokiri (2006) dir. Puri Jagannadh",2006,1
"498",498,"Wanted (2009) dir. Prabhu Deva","2009","Pokiri (2006) dir. Puri Jagannadh",2006,3
"499",499,"Porki (2010) dir. M.D. Sridhar","2010","Pokiri (2006) dir. Puri Jagannadh",2006,4
"500",500,"The Poseidon Adventure (2005) dir. John Putch","2005","The Poseidon Adventure (1972) dir. Ronald Neame",1972,33
"501",501,"Poseidon (2006) dir. Wolfgang Petersen","2006","The Poseidon Adventure (1972) dir. Ronald Neame",1972,34
"502",502,"The Preacher's Wife (1996) dir. Penny Marshall","1996","The Bishop's Wife (1947) dir. Henry Koster",1947,49
"503",503,"Premonition (2007) dir. Mennan Yapo","2007","Premonition (2004) dir. Norio Tsuruta
Based on the manga Kyoufu Shinbun (""Newspaper of Terror"") by Jiro Tsunoda",2004,3
"504",504,"The Prisoner of Zenda (1952) dir. Richard Thorpe","1952","The Prisoner of Zenda (1937) dir. John Cromwell and W. S. Van Dyke
Based on the novel by Anthony Hope",1937,15
"505",505,"The Prisoner of Zenda (1979) dir. Richard Quine","1979","The Prisoner of Zenda (1937) dir. John Cromwell and W. S. Van Dyke
Based on the novel by Anthony Hope",1937,42
"506",506,"The Producers (2005) dir. Susan Stroman","2005","The Producers (1968) dir. Mel Brooks",1968,37
"507",507,"Prom Night (2008) dir. Nelson McCormick","2008","Prom Night (1980) dir. Paul Lynch",1980,28
"508",508,"Psycho (1998) dir. Gus Van Sant","1998","Psycho (1960) dir. Alfred Hitchcock
Based on the novel by Robert Bloch",1960,38
"509",509,"Pulse (2006) dir. Jim Sonzero","2006","Kairo (2001) dir. Kiyoshi Kurosawa",2001,5
"510",510,"Pure Luck (1991) dir. Nadia Tass","1991","La Ch̬vre (1981) dir. Francis Veber",1981,10
"511",511,"Pusher (2010) dir. Assad Raja","2010","Pusher (1996) dir. Nicolas Winding Refn",1996,14
"512",512,"Quarantine (2008) dir. John Erick Dowdle","2008","REC (2007) dir. Jaume Balaguer�_ and Paco Plaza",2007,1
"513",513,"The Racket (1951) dir. John Cromwell","1951","The Racket (1928) dir. Lewis Milestone",1928,23
"514",514,"Der Regenmacher (1980) dir. Ludwig Cremer","1980","The Rainmaker (1956) dir. Joseph Anthony",1956,24
"515",515,"The Rainmaker (1982) dir. John Frankenheimer","1982","The Rainmaker (1956) dir. Joseph Anthony",1956,26
"516",516,"The Rains of Ranchipur (1955) dir. Jean Negulesco","1955","The Rains Came (1939) dir. Clarence Brown",1939,16
"517",517,"Ramgarh Ke Sholay (1991) dir. Ajit Dewani","1991","Sholay (1975) dir. Ramesh Sippy",1975,16
"518",518,"Ram Gopal Varma Ki Aag (2007) dir. Ram Gopal Varma","2007","Sholay (1975) dir. Ramesh Sippy",1975,32
"519",519,"Ransom (1996) dir. Ron Howard","1996","Ransom! (1956) dir. Alex Segal",1956,40
"520",520,"Rear Window (1998) dir. Jeff Bleckner","1998","Rear Window (1954) dir. Alfred Hitchcock
Based on the short story It Had to Be Murder by Cornell Woolrich",1954,44
"521",521,"Red Dawn (2012) dir. Dan Bradley","2012","Red Dawn (1984) dir. John Milius",1984,28
"522",522,"Red Dragon (2002) dir. Brett Ratner","2002","Manhunter (1986) dir. Michael Mann",1986,16
"523",523,"The Red Rider (1934) dir. Lew Landers","1934","Range Feud (1931) dir. D. Ross Lederman",1931,3
"524",524,"Reefer Madness (2005) dir. Andy Fickman","2005","Reefer Madness (1936) dir. Louis J. Gasnier",1936,69
"525",525,"Return to Paradise (1998) dir. Joseph Ruben","1998","Force Majeure (1989) dir. Pierre Jolievt",1989,9
"526",526,"Reptilian (1999) dir. Shim Hyung-rae","1999","Yonggary (1967) dir. Kim Ki-duk",1967,32
"527",527,"Rich And Famous (1981) dir. George Cukor","1981","Old Acquaintance (1943) dir. Vincent Sherman",1943,38
"528",528,"Ride Him, Cowboy (1932) dir. Fred Allen","1932","The Unknown Cavalier (1926) dir. Albert S. Rogell",1926,6
"529",529,"Riding High (1950) dir. Frank Capra","1950","Broadway Bill (1934) dir. Frank Capra",1934,16
"530",530,"The Ring (2002) dir. Gore Verbinski","2002","Ringu (1998) dir. Hideo Nakata",1998,4
"531",531,"Rio Lobo (1970) dir. Howard Hawks","1970","Rio Bravo (1959) dir. Howard Hawks",1959,11
"532",532,"Rio Rita (1942) dir. S. Sylvan Simon","1942","Rio Rita (1929) dir. Luther Reed",1929,13
"533",533,"The Adventures of Robin Hood (1938) dir. Michael Curtiz & William Keighley","1938","Robin Hood (1922) dir. Allan Dwan",1922,16
"534",534,"The Story of Robin Hood and His Merrie Men (1952) dir. Ken Annakin","1952","Robin Hood (1922) dir. Allan Dwan",1922,30
"535",535,"Robin Hood (1973) dir. Wolfgang Reitherman","1973","Robin Hood (1922) dir. Allan Dwan",1922,51
"536",536,"Robin Hood: Prince of Thieves (1991) dir. Kevin Reynolds","1991","Robin Hood (1922) dir. Allan Dwan",1922,69
"537",537,"Robin Hood (2010) dir. Ridley Scott","2010","Robin Hood (1922) dir. Allan Dwan",1922,88
"538",538,"RoboCop (2014) dir. Jos̩ Padilha","2014","RoboCop (1987) dir. Paul Verhoeven",1987,27
"539",539,"Rock-A-Bye Baby (1958) dir. Frank Tashlin","1958","The Miracle of Morgan's Creek (1944) dir. Preston Sturges",1944,14
"540",540,"Rollerball (2002) dir. John McTiernan","2002","Rollerball (1975) dir. Norman Jewison",1975,27
"541",541,"The Roman Spring of Mrs. Stone (2003) dir. Robert Allan Ackerman","2003","The Roman Spring of Mrs. Stone (1961) dir. Jos̩ Quintero",1961,42
"542",542,"Runaway Daughters (1994) dir. Joe Dante","1994","Runaway Daughters (1956) dir. Edward L. Cahn",1956,38
"543",543,"Sabine und die hundert M�_nner (1960) dir. Wilhelm Thiele","1960","One Hundred Men and a Girl (1937) dir. Henry Koster",1937,23
"544",544,"Sabrina (1995) dir. Sydney Pollack","1995","Sabrina (1954) dir. Billy Wilder
Based upon the stage play Sabrina Fair by Samuel Taylor",1954,41
"545",545,"Sahara (1995) dir. Brian Trenchard-Smith","1995","Sahara (1943) dir. Zoltan Korda",1943,52
"546",546,"Satan's School for Girls (2000) dir. Christopher Leitch","2000","Satan's School for Girls (1973) dir. David Rich",1973,27
"547",547,"Maybe It's Love (1935) dir. William McGann","1935","Saturday's Children (1929) dir. Gregory La Cava",1929,6
"548",548,"Maybe It's Love (1940) dir. William A. Wellman","1940","Saturday's Children (1929) dir. Gregory La Cava",1929,11
"549",549,"Scandal Maker (2016) dir. Ahn Byeong-ki","2016","Scandal Makers (2008) dir. Kang Hyeong-cheol",2008,8
"550",550,"Scared Stiff (1953) dir. George Marshall","1953","The Ghost Breakers (1940) dir. George Marshall",1940,13
"551",551,"Scarface (1983) dir. Brian De Palma","1983","Scarface (1932) dir. Howard Hawks",1932,51
"552",552,"Scent of a Woman (1992) dir. Martin Brest","1992","Profumo di donna (1974) dir. Dino Risi",1974,18
"553",553,"School for Scoundrels (2006) dir. Todd Phillips","2006","School for Scoundrels or How to Win Without Actually Cheating! (1960) dir. Robert Hamer",1960,46
"554",554,"The Secret (2007) dir. Vincent Perez","2007","Himitsu (1999) dir. Yojiro Takita",1999,8
"555",555,"Secret in Their Eyes (2015) dir. Billy Ray","2015","El secreto de sus ojos (2009) dir. Juan J. Campanella
Based on the novel La pregunta de sus ojos by Eduardo Sacheri",2009,6
"556",556,"The Secret Life of Walter Mitty (2013) dir. Ben Stiller","2013","The Secret Life of Walter Mitty (1947) dir. Norman Z. McLeod
Based on the short story by James Thurber",1947,66
"557",557,"Secret of the Blue Room (1933) dir. Kurt Neumann","1933","Geheimnis des blauen Zimmers (1932) dir. Erich Engels",1932,1
"558",558,"Sengoku jietai 1549 (2005)","2005","Sengoku jietai 1549 (1979)",1979,26
"559",559,"Senso '45 (2002) dir. Tinto Brass","2002","Senso (1979) dir. Luchino Visconti",1979,23
"560",560,"Seventh Heaven (1937) dir. Henry King","1937","Seventh Heaven (1927) dir. Frank Borzage",1927,10
"561",561,"Strange Homecoming (1974) dir. Lee H. Katzin[1]","1974","Shadow of a Doubt (1943) dir. Alfred Hitchcock",1943,31
"562",562,"Shadow of a Doubt (1991) dir. Karen Arthur","1991","Shadow of a Doubt (1943) dir. Alfred Hitchcock",1943,48
"563",563,"The Shaggy Dog (1994) dir. Dennis Dugan","1994","The Shaggy Dog (1959) dir. Charles Barton",1959,35
"564",564,"The Shaggy Dog (2006) dir. Brian Robbins","2006","The Shaggy Dog (1959) dir. Charles Barton",1959,47
"565",565,"Shake, Rattle and Rock! (1994) dir. Allan Arkush","1994","Shake, Rattle & Rock! (1956) dir. Edward L. Cahn",1956,38
"566",566,"The Shakiest Gun in the West (1968) dir. Alan Rafkin","1968","The Paleface (1948) dir. Norman Z. McLeod",1948,20
"567",567,"Shall We Dance (2004) dir. Peter Chelsom","2004","Shall We Dansu? (1996) dir. Masayuki Suo",1996,8
"568",568,"Shankar Dada MBBS (2004) dir. Jayanth C. Paranjee","2004","Munnabhai M.B.B.S. (2003) dir. Rajkumar Hirani",2003,1
"569",569,"Shankar Dada Zindabad (2007) dir. Prabhu Deva","2007","Lage Raho Munna Bhai (2006) dir. Rajkumar Hirani",2006,1
"570",570,"Shiva (1990) dir. Ram Gopal Varma","1990","Shiva (1989) dir. Ram Gopal Varma",1989,1
"571",571,"Shiva (2006) dir. Ram Gopal Varma","2006","Shiva (1989) dir. Ram Gopal Varma",1989,17
"572",572,"The Shopworn Angel (1938) dir. H.C. Potter","1938","The Shopworn Angel (1928) dir. Richard Wallace",1928,10
"573",573,"Shortcut to Happiness (2003) dir. Alec Baldwin","2003","The Devil and Daniel Webster (1941) dir. William Dieterle",1941,62
"574",574,"Show Boat (1936) dir. James Whale","1936","Show Boat (1929) dir. Harry A. Pollard",1929,7
"575",575,"Show Boat (1951) dir. George Sidney","1951","Show Boat (1929) dir. Harry A. Pollard",1929,22
"576",576,"Sideways (2009) dir. Cellin Gluck","2009","Sideways (2004) dir. Alexander Payne",2004,5
"577",577,"Silk Stockings (1957) dir. Rouben Mamoulian","1957","Ninotchka (1939) dir. Ernst Lubitsch",1939,18
"578",578,"The Sign of the Cross (1932) dir. Cecil B. DeMille","1932","The Sign of the Cross (1914) dir. Frederick A. Thomson",1914,18
"579",579,"The Adventures of Ichabod and Mr. Toad (1949) dir. Clyde Geronimi","1949","The Headless Horseman (1922) dir. Edward D. Venturini",1922,27
"580",580,"The Legend of Sleepy Hollow (1980) dir. Henning Schellerup","1980","The Headless Horseman (1922) dir. Edward D. Venturini",1922,58
"581",581,"Sleepy Hollow (1999) dir. Tim Burton","1999","The Headless Horseman (1922) dir. Edward D. Venturini",1922,77
"582",582,"Society Lawyer (1939) dir. Edwin L. Marin","1939","Penthouse (1933) dir. W.S. Van Dyke",1933,6
"583",583,"Solaris (1972) dir. Andrei Tarkovsky","1972","Solaris (1968) dir. B.Nirenburg
Based on the novel by Stanis��aw Lem",1968,4
"584",584,"Solaris (2002) dir. Steven Soderbergh","2002","Solaris (1968) dir. B.Nirenburg
Based on the novel by Stanis��aw Lem",1968,34
"585",585,"Solstice (2008) dir. Daniel Myrick","2008","Midsommer (2003) dir. Carsten Myllerup",2003,5
"586",586,"Something's Got to Give (unfinished) (1962) dir. George Cukor","1962","My Favorite Wife (1940) dir. Garson Kanin",1940,22
"587",587,"Somewhere in Sonora (1933) dir. Mack V. Wright","1933","Somewhere in Sonora (1927) dir. Albert S. Rogell",1927,6
"588",588,"A Song Is Born (1948) dir. Howard Hawks","1948","Ball of Fire (1941) dir. Howard Hawks",1941,7
"589",589,"Sorcerer (1977) dir. William Friedkin","1977","Le Salaire de la Peur (1953) dir. Henri-Georges Clouzot",1953,24
"590",590,"Sorority Row (2009) dir. Stewart Hendler","2009","The House on Sorority Row (1983) dir. Mark Rosman",1983,26
"591",591,"Sorrell and Son (1934) dir. Jack Raymond","1934","Sorrell and Son (1927) dir. Herbert Brenon",1927,7
"592",592,"Sorrowful Jones (1949) dir. Sidney Lanfield","1949","Little Miss Marker (1934) dir. Alexander Hall
Based on a short story by Damon Runyon",1934,15
"593",593,"Sparkle (2012) dir. Salim Akil","2012","Sparkle (1976) dir. Sam O'Steen",1976,36
"594",594,"Spring Parade (1940) dir. Henry Koster","1940","Spring Parade (1934) dir. G̩za von Bolv��ry",1934,6
"595",595,"Springtime in a Small Town (2002) dir. Tian Zhuangzhuang","2002","Spring in a Small Town (1948) dir. Fei Mu",1948,54
"596",596,"The Squaw Man (1918) dir. Cecil B. DeMille","1918","The Squaw Man (1914) dir. Cecil B. DeMille",1914,4
"597",597,"The Squaw Man (1931) dir. Cecil B. DeMille","1931","The Squaw Man (1914) dir. Cecil B. DeMille",1914,17
"598",598,"Stage Struck (1958) dir. Sidney Lumet","1958","Morning Glory (1933) dir. Lowell Sherman
Based on a play by Zo�� Akins",1933,25
"599",599,"Stagecoach (1966) dir. Gordon Douglas","1966","Stagecoach (1939) dir. John Ford
Based on the short story ""Stage to Lordsburg"" by Ernest Haycox",1939,27
"600",600,"Stagecoach (1986) dir. Ted Post","1986","Stagecoach (1939) dir. John Ford
Based on the short story ""Stage to Lordsburg"" by Ernest Haycox",1939,47
"601",601,"A Star Is Born (1954) dir. George Cukor","1954","A Star Is Born (1937) dir. William A. Wellman",1937,17
"602",602,"A Star Is Born (1976) dir. Frank R. Pierson","1976","A Star Is Born (1937) dir. William A. Wellman",1937,39
"603",603,"A Star Is Born (2018) dir. Bradley Cooper","2018","A Star Is Born (1937) dir. William A. Wellman",1937,81
"604",604,"State Fair (1945) dir. Walter Lang","1945","State Fair (non-musical version) (1933) dir. Henry King
Based on the novel by Phil Stong",1933,12
"605",605,"State Fair (1962) dir. Jos̩ Ferrer","1962","State Fair (non-musical version) (1933) dir. Henry King
Based on the novel by Phil Stong",1933,29
"606",606,"The Stepfather (2009) dir. Nelson McCormick","2009","The Stepfather (1987) dir. Joseph Ruben",1987,22
"607",607,"The Stepford Wives (2004) dir. Frank Oz","2004","The Stepford Wives (1975) dir. Bryan Forbes
Based on the novel by Ira Levin",1975,29
"608",608,"Stolen Hours (1963) dir. Daniel Petrie","1963","Dark Victory (1939) dir. Edmund Goulding
Based on the play by George Emerson Brewer Jr. and Bertram Bloch",1939,24
"609",609,"Straw Dogs (2011) dir. Rod Lurie","2011","Straw Dogs (1971) dir. Sam Peckinpah
Based on the novel by Gordon Williams",1971,40
"610",610,"The Student of Prague (1926) dir. Henrik Galeen","1926","The Student of Prague (1913) dir. Paul Wegener",1913,13
"611",611,"The Student of Prague (1935) dir. Arthur Robison","1935","The Student of Prague (1913) dir. Paul Wegener",1913,22
"612",612,"The Sunshine Boys (1996) dir. John Erman","1996","The Sunshine Boys (1975) dir. Herbert Ross
Based on the play by Neil Simon",1975,21
"613",613,"Sunset Boulevard (1956) dir. Tad Danielewski","1956","Sunset Boulevard (1950) dir. Billy Wilder",1950,6
"614",614,"Suspicion (1987) dir. Andrew Grieve","1987","Suspicion (1941) dir. Alfred Hitchcock",1941,46
"615",615,"One Romantic Night (1930) dir. Paul Stein","1930","The Swan (1925) dir. Dimitri Buchowetzki
Based on the play by Ferenc Moln��r",1925,5
"616",616,"The Swan (1956) dir. Charles Vidor","1956","The Swan (1925) dir. Dimitri Buchowetzki
Based on the play by Ferenc Moln��r",1925,31
"617",617,"Sweet 20 (2015) dir. Phan Gia Nhat Linh","2015","Miss Granny (2014) dir. Hwang Dong-hyuk",2014,1
"618",618,"Sweet November (2001) dir. Pat O'Connor","2001","Sweet November (1968) dir. Robert Ellis Miller",1968,33
"619",619,"Swept Away (2002) dir. Guy Ritchie","2002","Swept Away by an Unusual Destiny in the Blue Sea of August (1974) dir. Lina Wertm�_ller",1974,28
"620",620,"Swiss Family Robinson (1960) dir. Ken Annakin","1960","Swiss Family Robinson (1940) dir. Edward Ludwig",1940,20
"621",621,"His Girl Friday (1940) dir. Howard Hawks","1940","The Front Page (1931) dir. Lewis Milestone",1931,9
"622",622,"The Front Page (1974) dir. Billy Wilder","1974","The Front Page (1931) dir. Lewis Milestone",1931,43
"623",623,"Switching Channels (1988) dir. Ted Kotcheff","1988","The Front Page (1931) dir. Lewis Milestone",1931,57
"624",624,"Tagore (2003) dir. V.V. Vinayak","2003","Ramana (2002) dir. A.R. Murugadoss",2002,1
"625",625,"The Taking of Pelham One Two Three (1998) dir. F̩lix Enr�_quez Alcala","1998","Taking of Pelham One Two Three (1974) dir. Joseph Sargent",1974,24
"626",626,"The Taking of Pelham 1 2 3 (2009) dir. Tony Scott","2009","Taking of Pelham One Two Three (1974) dir. Joseph Sargent",1974,35
"627",627,"Tarzan, the Ape Man (1959) dir. Joseph M. Newman","1959","Tarzan the Ape Man (1932) dir. W.S. Van Dyke",1932,27
"628",628,"Taxi (2004) dir. Tim Story","2004","Taxi (1996) dir. G̩rard Pir̬s",1996,8
"629",629,"Mutiny on the Bounty (1935) dir. Frank Lloyd","1935","In the Wake of the Bounty (1933) dir. Charles Chauvel",1933,2
"630",630,"Mutiny on the Bounty (1962) dir. Lewis Milestone","1962","In the Wake of the Bounty (1933) dir. Charles Chauvel",1933,29
"631",631,"The Bounty (1984) dir. Roger Donaldson","1984","In the Wake of the Bounty (1933) dir. Charles Chauvel",1933,51
"632",632,"The Texas Chainsaw Massacre (2003) dir. Marcus Nispel","2003","The Texas Chain Saw Massacre (1974) dir. Tobe Hooper",1974,29
"633",633,"That Darn Cat (1997) dir. Bob Spiers","1997","That Darn Cat! (1965) dir. Robert Stevenson
Based on the book Undercover Cat by The Gordons",1965,32
"634",634,"They Made Me a Criminal (1939) dir. Busby Berkeley","1939","The Life of Jimmy Dolan (1933) dir. Archie Mayo",1933,6
"635",635,"The Thief of Bagdad (1940) dir. Ludwig Berger and Michael Powell","1940","Thief of Bagdad (1924) dir. Raoul Walsh",1924,16
"636",636,"The Thief of Baghdad (1978) dir. Clive Donner","1978","Thief of Bagdad (1924) dir. Raoul Walsh",1924,54
"637",637,"Yamato Takeru (1994) dir. Takao Okawara","1994","The Birth of Japan (1959) dir. Hiroshi Inagaki",1959,35
"638",638,"The Thing (1982) dir. John Carpenter","1982","The Thing from Another World (1951) dir. Christian Nyby & Howard Hawks
Based on the novel Who Goes There? by John W. Campbell",1951,31
"639",639,"The Thirteenth Floor (1999) dir. Josef Rusnak","1999","Welt am Draht (1973) dir. Rainer Werner Fassbinder
Based on the novel Simulacron-3 by Daniel F. Galouye",1973,26
"640",640,"Thir13en Ghosts (2001) dir. Steve Beck","2001","13 Ghosts (1960) dir. William Castle",1960,41
"641",641,"The 39 Steps (1959) dir. Ralph Thomas","1959","The 39 Steps (1935) dir. Alfred Hitchcock",1935,24
"642",642,"The Thirty Nine Steps (1978) dir. Don Sharp","1978","The 39 Steps (1935) dir. Alfred Hitchcock",1935,43
"643",643,"The 39 Steps (2008) dir. James Hawes","2008","The 39 Steps (1935) dir. Alfred Hitchcock",1935,73
"644",644,"The Thomas Crown Affair (1999) dir. John McTiernan","1999","The Thomas Crown Affair (1968) dir. Norman Jewison",1968,31
"645",645,"Three Fugitives (1989) dir. Francis Veber","1989","Les Fugitifs (1986) dir. Francis Veber",1986,3
"646",646,"The Three Musketeers (1935) dir. Rowland V. Lee","1935","The Three Musketeers (1921) dir. Fred Niblo",1921,14
"647",647,"The Three Musketeers (1948) dir. George Sidney","1948","The Three Musketeers (1921) dir. Fred Niblo",1921,27
"648",648,"The Three Musketeers (1973) dir. Richard Lester","1973","The Three Musketeers (1921) dir. Fred Niblo",1921,52
"649",649,"The Three Musketeers (1993) dir. Stephen Herek","1993","The Three Musketeers (1921) dir. Fred Niblo",1921,72
"650",650,"The Three Musketeers (2011) dir. Paul W. S. Anderson","2011","The Three Musketeers (1921) dir. Fred Niblo",1921,90
"651",651,"The Time Machine (2002) dir. Simon Wells","2002","The Time Machine (1960) dir. George Pal
Based on the novella by H. G. Wells",1960,42
"652",652,"To Be Or Not To Be (1983) dir. Alan Johnson","1983","To Be Or Not To Be (1942) dir. Ernst Lubitsch",1942,41
"653",653,"To Have and to Hold (1922) dir. Jesse L. Lasky","1922","To Have and to Hold (1916) dir. George Melford",1916,6
"654",654,"Tol'able David (1930) dir. John G. Blystone","1930","Tol'able David (1921) dir. Henry King",1921,9
"655",655,"Too Good to Be True (1988) dir. Christian I. Nyby, II","1988","Leave Her to Heaven (1945) dir. John M. Stahl",1945,43
"656",656,"Toolbox Murders (2004) dir. Tobe Hooper","2004","The Toolbox Murders (1978) dir. Dennis Donnelly",1978,26
"657",657,"Tortilla Soup (2001) dir. Mar�_a Ripoll","2001","Eat Drink Man Woman (1994) dir. Ang Lee",1994,7
"658",658,"Total Recall (2012) dir. Len Wiseman","2012","Total Recall (1990) dir. Paul Verhoeven
Based on the short story We Can Remember It for You Wholesale by Philip K. Dick",1990,22
"659",659,"The Tourist (2010) dir. Florian Henckel von Donnersmarck","2010","Anthony Zimmer (2005) dir. J̩r̫me Salle",2005,5
"660",660,"Tower of London (1962) dir. Roger Corman","1962","Tower of London (1939) dir. Rowland V. Lee",1939,23
"661",661,"The Town That Dreaded Sundown (2014) dir. Alfonso Gomez-Rejon","2014","The Town That Dreaded Sundown (1977) dir. Charles B. Pierce",1977,37
"662",662,"The Toy (1982) dir. Richard Donner","1982","Le Jouet (1976) dir. Francis Veber",1976,6
"663",663,"Trader Horn (1973) dir. Reza Badiyi","1973","Trader Horn (1931) dir. W.S. Van Dyke",1931,42
"664",664,"True Lies (1994) dir. James Cameron","1994","La Totale! (1991) dir. Claude Zidi",1991,3
"665",665,"The Truth About Charlie (2002) dir. Jonathan Demme","2002","Charade (1963) dir. Stanley Donen",1963,39
"666",666,"Two Much (1996) dir. Fernando Trueba","1996","Le jumeau (1984) dir. Yves Robert
Based on Two Much by Donald E. Westlake",1984,12
"667",667,"Unfaithful (2002) dir. Adrian Lyne","2002","La femme infid̬le (1969) dir. Claude Chabrol",1969,33
"668",668,"Unfaithfully Yours (1984) dir. Howard Zieff","1984","Unfaithfully Yours (1948) dir. Preston Sturges",1948,36
"669",669,"Under Suspicion (2000) dir. Stephen Hopkins","2000","Garde �� vue (1981) dir. Claude Miller",1981,19
"670",670,"The Underneath (1995) dir. Steven Soderbergh","1995","Criss Cross (1949) dir. Robert Siodmak
Based on the novel Criss Cross by Don Tracy",1949,46
"671",671,"The Unholy Three (1930) dir. Jack Conway","1930","The Unholy Three (1925) dir. Tod Browning",1925,5
"672",672,"The Unknown Soldier (1985) dir. Rauni Mollberg","1985","The Unknown Soldier (1955) dir. Edvin Laine",1955,30
"673",673,"Van Gogh (1948) dir. Alain Resnais","1948","Van Gogh (1947) dir. Alain Resnais",1947,1
"674",674,"Vanilla Sky (2001) dir. Cameron Crowe","2001","Abre Los Ojos (1997) dir. Alejandro Amen��bar",1997,4
"675",675,"The Vanishing (1993) dir. George Sluizer","1993","Spoorloos (1988) dir George Sluizer",1988,5
"676",676,"Vanishing Point (1997) dir. Charles Robert Carner","1997","Vanishing Point (1971) dir. Richard C. Sarafian",1971,26
"677",677,"V�_stkustens hj�_ltar (1940) dir. Lau Lauritzen, Jr. & Alice O'Fredericks","1940","Blaavand melder storm (1938) dir. Lau Lauritzen, Jr. & Alice O'Fredericks",1938,2
"678",678,"Vicki (1953) dir. Harry Horner","1953","I Wake Up Screaming (1942) dir. H. Bruce Humberstone",1942,11
"679",679,"First a Girl (1935) dir. Victor Saville","1935","Viktor und Viktoria (1933) dir. Reinhold Schunzel",1933,2
"680",680,"Victor and Victoria (1957) dir. Karl Anton","1957","Viktor und Viktoria (1933) dir. Reinhold Schunzel",1933,24
"681",681,"Victor/Victoria (1982) dir. Blake Edwards","1982","Viktor und Viktoria (1933) dir. Reinhold Schunzel",1933,49
"682",682,"Village of the Damned (1995) dir. John Carpenter","1995","Village of the Damned (1960) dir. Wolf Rilla
Based on the novel The Midwich Cuckoos by John Wyndham",1960,35
"683",683,"Walk Don't Run (1966) dir. Charles Walters","1966","The More the Merrier (1943) dir. George Stevens",1943,23
"684",684,"A Walk in the Clouds (1995) dir. Alfonso Arau","1995","Sous le ciel de Provence (1956) dir. Mario Soldati",1956,39
"685",685,"Walking Tall (2004) dir. Kevin Bray","2004","Walking Tall (1973) dir. Phil Karlson",1973,31
"686",686,"Waterloo Bridge (1940) dir. Mervyn LeRoy","1940","Waterloo Bridge (1931) dir. James Whale",1931,9
"687",687,"War of the Worlds (2005) dir. Steven Spielberg","2005","The War of the Worlds (1953) dir. Byron Haskin",1953,52
"688",688,"The Way of All Flesh (1940) dir. Louis King","1940","The Way of All Flesh (1927) dir. Victor Fleming",1927,13
"689",689,"Web of the Spider (1971) dir. Antonio Margheriti","1971","Castle of Blood (1964) dir. Antonio Margheriti",1964,7
"690",690,"We Are Family (2010) dir. Siddharth Malhotra","2010","Stepmom (1998) dir. Chris Columbus",1998,12
"691",691,"Crackers (1984) dir. Louis Malle","1984","Big Deal on Madonna Street (1958) dir. Mario Monicelli",1958,26
"692",692,"Welcome to Collinwood (2002) dir. Anthony Russo & Joe Russo","2002","Big Deal on Madonna Street (1958) dir. Mario Monicelli",1958,44
"693",693,"We're No Angels (1989) dir. Neil Jordan","1989","We're No Angels (1955) dir. Michael Curtiz",1955,34
"694",694,"What a Girl Wants (2003) dir. Dennie Gordon","2003","The Reluctant Debutante (1958) dir. Vincente Minnelli",1958,45
"695",695,"What Ever Happened to Baby Jane? (1991) dir. David Greene","1991","What Ever Happened to Baby Jane? (1962) dir. Robert Aldrich",1962,29
"696",696,"What Women Want (2011) dir. Chen Daming","2011","What Women Want (2000) dir. Nancy Meyers",2000,11
"697",697,"When a Stranger Calls (2006) dir. Simon West","2006","When a Stranger Calls (1979) dir. Fred Walton",1979,27
"698",698,"Where the Boys Are '84 (1984) dir. Hy Averback","1984","Where the Boys Are (1960) dir. Henry Levin",1960,24
"699",699,"The Wicked Lady (1983) dir. Michael Winner","1983","The Wicked Lady (1945) dir. Leslie Arliss",1945,38
"700",700,"The Wicker Man (2006) dir. Neil LaBute","2006","The Wicker Man (1973) dir. Robin Hardy",1973,33
"701",701,"Wicker Park (2004) dir. Paul McGuigan","2004","L'Appartement (1996) dir. Gilles Mimouni",1996,8
"702",702,"Willard (2003) dir. Glen Morgan","2003","Willard (1971) dir. Daniel Mann",1971,32
"703",703,"The Witness (2015) dir. Ahn Sang-hoon","2015","Blind (2011) dir. Ahn Sang-hoon",2011,4
"704",704,"The Wizard of Gore (2007) dir. Jeremy Kasten","2007","The Wizard of Gore (1970) dir. Herschell Gordon Lewis",1970,37
"705",705,"The Wolfman (2010) dir. Joe Johnston","2010","The Wolf Man (1941) dir. George Waggner",1941,69
"706",706,"The Woman in Black (2012) dir. James Watkins","2012","The Woman in Black (1989) dir. Herbert Wise",1989,23
"707",707,"The Woman in Red (1984) dir. Gene Wilder","1984","Un ̩l̩phant ̤a trompe ̩norm̩ment (1976) dir. Yves Robert",1976,8
"708",708,"The Opposite Sex (1956) dir. David Miller","1956","The Women (1939) dir. George Cukor",1939,17
"709",709,"The Women (2008) dir. Diane English","2008","The Women (1939) dir. George Cukor",1939,69
"710",710,"The Wool Cap (2004) dir. Steven Schachter","2004","Gigot (1962) dir. Gene Kelly",1962,42
"711",711,"The Yellow Handkerchief (2010) dir. Udayan Prasad","2010","The Yellow Handkerchief (1977) dir. Yoji Yamada",1977,33
"712",712,"Yogi (2007) dir. V.V. Vinayak","2007","Jogi (2005) dir. Prem",2005,2
"713",713,"Eve Knew Her Apples (1945) dir. Will Jason","1945","It Happened One Night (1934) dir. Frank Capra",1934,11
"714",714,"You Can't Run Away from It (1956) dir. Dick Powell","1956","It Happened One Night (1934) dir. Frank Capra",1934,22
"715",715,"Young Frankenstein (1974) dir. Mel Brooks","1974","Son of Frankenstein (1939) dir. Rowland V. Lee",1939,35
"716",716,"Yours, Mine and Ours (2005) dir. Raja Gosnell","2005","Yours, Mine and Ours (1968) dir. Melville Shavelson",1968,37
"717",717,"You're Never Too Young (1955) dir. Norman Taurog","1955","The Major and the Minor (1942) dir. Billy Wilder",1942,13
"718",718,"In the Good Old Summertime (1949) dir. Robert Z. Leonard","1949","The Shop Around the Corner (1940) dir. Ernst Lubitsch
Based on the play by Mikl�_s L��szl�_",1940,9
"719",719,"Pillow Talk (1959) dir. Michael Gordon","1959","The Shop Around the Corner (1940) dir. Ernst Lubitsch
Based on the play by Mikl�_s L��szl�_",1940,19
"720",720,"You've Got Mail (1998) dir. Nora Ephron","1998","The Shop Around the Corner (1940) dir. Ernst Lubitsch
Based on the play by Mikl�_s L��szl�_",1940,58
